,khipu_id,name,cluster_sum,is_top_cluster,is_duplicate_cluster,left_cluster_id,left_cluster_position,left_num_cluster_cords,left_cluster_sum_string,right_cluster_id,right_cluster_position,right_num_cluster_cords,right_cluster_sum_string,cluster_distance,cord_count_distance
0,1000209,AS041,194,False,False,1005940,1,7,"LD@[2, 1]:5 + RL@[2, 2]:50 + MB@[2, 3]:7 + W:LD@[2, 4]:70 + <span style=""color:#F80000;"">RL@[2, 1, 1]:2</span> + <span style=""color:#F80000;"">RL@[2, 2, 1]:30</span> + <span style=""color:#F80000;"">RL@[2, 4, 1]:30</span>",1005945,6,6,"LD@[7, 1]:7 + W:RL@[7, 2]:80 + W:LD@[7, 3]:50 + <span style=""color:#F80000;"">RL@[7, 1, 1]:3</span> + <span style=""color:#F80000;"">MB@[7, 1, 2]:4</span> + <span style=""color:#F80000;"">W:RL@[7, 2, 1]:50</span>",5,1
1,1000345,AS044,34,True,False,1012946,6,7,"W:LB@[7, 1]:1 + W:LB@[7, 2]:11 + W:LB@[7, 3]:2 + W:LB@[7, 4]:11 + W:LB@[7, 5]:0 + W:LB@[7, 6]:6 + <span style=""color:#F80000;"">LB@[7, 3, 1]:3</span>",1012947,7,1,"W:LB@[8, 1]:34",1,6
2,1000345,AS044,43,False,False,1012952,12,5,"W:B@[13, 1]:1 + W:LB@[13, 2]:7 + W:LB@[13, 3]:27 + W:LB@[13, 4]:3 + <span style=""color:#F80000;"">LB@[13, 2, 1]:5</span>",1012962,22,13,"W-LB@[23, 1]:12 + W-LB@[23, 2]:6 + W-LB@[23, 3]:2 + W:LB@[23, 4]:8 + W:LB@[23, 5]:1 + W:LB@[23, 6]:3 + <span style=""color:#F80000;"">W@[23, 2, 1]:2</span> + <span style=""color:#F80000;"">LB@[23, 2, 2]:1</span> + <span style=""color:#F80000;"">B@[23, 2, 3]:2</span> + <span style=""color:#F80000;"">LB@[23, 3, 1]:1</span> + <span style=""color:#F80000;"">B@[23, 4, 1]:2</span> + <span style=""color:#F80000;"">LB@[23, 4, 2]:1</span> + <span style=""color:#F80000;"">LB@[23, 5, 1]:2</span>",10,8
3,1000345,AS044,48,True,False,1012956,16,9,"W:LB@[17, 1]:0 + W:LB@[17, 2]:10 + W:LB@[17, 3]:6 + W:LB@[17, 4]:16 + W:LB@[17, 5]:7 + W:LB@[17, 6]:4 + <span style=""color:#F80000;"">W:LB@[17, 3, 1]:2</span> + <span style=""color:#F80000;"">LB@[17, 3, 2]:2</span> + <span style=""color:#F80000;"">LB@[17, 4, 1]:1</span>",1012957,17,1,"W:LB@[18, 1]:48",1,8
4,1000178,AS062,25,False,False,1005390,1,4,"W@[2, 1]:6 + KB@[2, 2]:15 + <span style=""color:#F80000;"">KB@[2, 1, 1]:0</span> + <span style=""color:#F80000;"">W@[2, 2, 1]:4</span>",1005392,3,4,"W@[4, 1]:6 + KB@[4, 2]:11 + <span style=""color:#F80000;"">KB@[4, 1, 1]:1</span> + <span style=""color:#F80000;"">W@[4, 2, 1]:7</span>",2,0
5,1000369,AS066,55,False,False,1013518,8,3,"W@[9, 1]:16 + W@[9, 2]:15 + W@[9, 3]:24",1013536,24,4,"MB@[25, 1]:13 + MB@[25, 2]:17 + MB@[25, 3]:8 + MB@[25, 4]:17",16,1
6,1000369,AS066,25,False,False,1013539,27,4,"MB@[28, 1]:6 + MB@[28, 2]:7 + MB@[28, 3]:6 + MB@[28, 4]:6",1013540,28,4,"MB@[29, 1]:6 + MB@[29, 2]:6 + MB@[29, 3]:7 + MB@[29, 4]:6",1,0
7,1000369,AS066,25,False,False,1013542,30,4,"MB@[31, 1]:6 + MB@[31, 2]:6 + MB@[31, 3]:7 + MB@[31, 4]:6",1013552,40,4,"W@[41, 1]:7 + W@[41, 2]:6 + W@[41, 3]:6 + W@[41, 4]:6",10,0
8,1000369,AS066,52,False,True,1013549,37,4,"W@[38, 1]:13 + W@[38, 2]:13 + W@[38, 3]:13 + W@[38, 4]:13",1013551,39,4,"W@[40, 1]:13 + W@[40, 2]:13 + W@[40, 3]:13 + W@[40, 4]:13",2,0
9,1000369,AS066,100,False,False,1013555,43,4,"MB@[44, 1]:28 + MB@[44, 2]:28 + MB@[44, 3]:29 + MB@[44, 4]:15",1013557,44,4,"MB@[45, 1]:25 + MB@[45, 2]:25 + MB@[45, 3]:25 + @[45, 4]:25",1,0
10,1000369,AS066,200,True,False,1013556,45,1,"MB@[46, 1]:200",1013567,55,8,"MB@[56, 1]:25 + MB@[56, 2]:25 + MB@[56, 3]:31 + MB@[56, 4]:19 + MB@[56, 5]:25 + MB@[56, 6]:25 + MB@[56, 7]:25 + MB@[56, 8]:25",10,7
11,1000369,AS066,32,True,False,1013558,46,8,"KB@[47, 1]:4 + MB@[47, 2]:4 + MB@[47, 3]:4 + MB@[47, 4]:4 + MB@[47, 5]:4 + MB@[47, 6]:4 + MB@[47, 7]:4 + MB@[47, 8]:4",1013559,47,1,"@[48, 1]:32",1,7
12,1000369,AS066,237,True,False,1013560,48,8,"W@[49, 1]:31 + W@[49, 2]:31 + W@[49, 3]:32 + W@[49, 4]:18 + W@[49, 5]:31 + W@[49, 6]:31 + W@[49, 7]:32 + W@[49, 8]:31",1013561,49,1,"MB@[50, 1]:237",1,7
13,1000369,AS066,32,True,False,1013571,59,8,"W@[60, 1]:4 + W@[60, 2]:4 + W@[60, 3]:4 + W@[60, 4]:4 + W@[60, 5]:4 + W@[60, 6]:4 + W@[60, 7]:4 + W@[60, 8]:4",1013572,60,1,"W@[61, 1]:32",1,7
14,1000096,AS069,22,False,False,1003502,0,8,"W@[1, 1]:0 + W@[1, 2]:0 + W@[1, 3]:0 + W@[1, 4]:0 + W@[1, 5]:6 + W@[1, 6]:0 + W@[1, 7]:0 + <span style=""color:#F80000;"">W@[1, 5, 1]:16</span>",1003472,345,7,"W@[346, 1]:0 + W@[346, 2]:11 + W@[346, 3]:0 + W@[346, 4]:0 + W@[346, 5]:11 + W@[346, 6]:0 + W@[346, 7]:0",345,1
15,1000096,AS069,21,False,False,1003562,16,6,"W@[17, 1]:0 + W@[17, 2]:1 + W@[17, 3]:0 + W@[17, 4]:0 + W@[17, 5]:20 + W@[17, 6]:0",1003450,342,7,"W@[343, 1]:0 + W@[343, 2]:0 + W@[343, 3]:0 + W@[343, 4]:0 + W@[343, 5]:21 + W@[343, 6]:0 + W@[343, 7]:0",326,1
16,1000096,AS069,120,False,False,1003580,25,6,"W@[26, 1]:0 + W@[26, 2]:120 + W@[26, 3]:0 + W@[26, 4]:0 + W@[26, 5]:0 + W@[26, 6]:0",1003339,266,7,"W@[267, 1]:0 + W@[267, 2]:120 + W@[267, 3]:0 + W@[267, 4]:0 + W@[267, 5]:0 + W@[267, 6]:0 + W@[267, 7]:0",241,1
17,1000096,AS069,42,False,False,1003604,27,7,"W@[28, 1]:0 + W@[28, 2]:20 + W@[28, 3]:0 + W@[28, 4]:2 + W@[28, 5]:10 + W@[28, 6]:10 + W@[28, 7]:0",1003378,253,6,"W@[254, 1]:0 + W@[254, 2]:11 + W@[254, 3]:31 + W@[254, 4]:0 + W@[254, 5]:0 + W@[254, 6]:0",226,1
18,1000096,AS069,87,False,False,1003510,68,7,"W@[69, 1]:0 + W@[69, 2]:30 + W@[69, 3]:20 + W@[69, 4]:2 + W@[69, 5]:35 + W@[69, 6]:0 + W@[69, 7]:0",1003538,94,16,"W@[95, 1]:0 + W@[95, 2]:5 + W@[95, 3]:4 + W@[95, 4]:10 + W@[95, 5]:7 + W@[95, 6]:15 + W@[95, 7]:0 + W@[95, 8]:0 + W@[95, 9]:0 + W@[95, 10]:0 + W@[95, 11]:0 + W@[95, 12]:0 + W@[95, 13]:0 + W@[95, 14]:0 + <span style=""color:#F80000;"">W:KB@[95, 2, 1]:33</span> + <span style=""color:#F80000;"">W:KB@[95, 9, 1]:13</span>",26,9
19,1000096,AS069,52,False,False,1003508,70,7,"W@[71, 1]:0 + W@[71, 2]:0 + W@[71, 3]:20 + W@[71, 4]:0 + @[71, 5]:12 + W@[71, 6]:20 + W@[71, 7]:0",1003353,226,1,"W:KB@[227, 1]:52",156,6
20,1000096,AS069,33,False,False,1003680,112,10,"W@[113, 1]:0 + W@[113, 2]:0 + W@[113, 3]:0 + W@[113, 4]:0 + W@[113, 5]:0 + W@[113, 6]:0 + W@[113, 7]:0 + <span style=""color:#F80000;"">W-FB@[113, 3, 1]:10</span> + <span style=""color:#F80000;"">W-FB@[113, 5, 1]:0</span> + <span style=""color:#F80000;"">W-KB@[113, 5, 1, 1]:23</span>",1003408,384,14,"W@[385, 1]:0 + W@[385, 2]:0 + W@[385, 3]:0 + W@[385, 4]:3 + W@[385, 5]:12 + W@[385, 6]:0 + W@[385, 7]:0 + <span style=""color:#F80000;"">W@[385, 1, 1]:0</span> + <span style=""color:#F80000;"">W@[385, 2, 1]:10</span> + <span style=""color:#F80000;"">W@[385, 3, 1]:0</span> + <span style=""color:#F80000;"">W@[385, 4, 1]:0</span> + <span style=""color:#F80000;"">W@[385, 5, 1]:8</span> + <span style=""color:#F80000;"">W@[385, 6, 1]:0</span> + <span style=""color:#F80000;"">W@[385, 7, 1]:0</span>",272,4
21,1000096,AS069,25,False,False,1003652,194,7,"W@[195, 1]:0 + W@[195, 2]:20 + W@[195, 3]:0 + W@[195, 4]:0 + W@[195, 5]:5 + W@[195, 6]:0 + W@[195, 7]:0",1003314,294,7,"W@[295, 1]:0 + W@[295, 2]:25 + W@[295, 3]:0 + W@[295, 4]:0 + W@[295, 5]:0 + W@[295, 6]:0 + W@[295, 7]:0",100,0
22,1000096,AS069,26,False,False,1003638,208,7,"W@[209, 1]:0 + W@[209, 2]:0 + W@[209, 3]:0 + W@[209, 4]:0 + W@[209, 5]:13 + W@[209, 6]:0 + <span style=""color:#F80000;"">W@[209, 5, 1]:13</span>",1003500,213,7,"W@[214, 1]:0 + W@[214, 2]:10 + W@[214, 3]:2 + W@[214, 4]:2 + W@[214, 5]:12 + W@[214, 6]:0 + W@[214, 7]:0",5,0
23,1000096,AS069,51,False,False,1003367,240,1,"W@[241, 1]:51",1003368,263,6,"W@[264, 1]:0 + W@[264, 2]:51 + W@[264, 3]:0 + W@[264, 4]:0 + W@[264, 5]:0 + W@[264, 6]:0",23,5
24,1000096,AS069,34,False,False,1003311,291,7,"W@[292, 1]:0 + W@[292, 2]:10 + W@[292, 3]:0 + W@[292, 4]:0 + W@[292, 5]:24 + W@[292, 6]:0 + W@[292, 7]:0",1003426,420,6,"W@[421, 1]:0 + W@[421, 2]:15 + W@[421, 3]:0 + W@[421, 4]:5 + W@[421, 5]:14 + W@[421, 6]:0",129,1
25,1000096,AS069,177,False,False,1003333,299,7,"W@[300, 1]:1 + W@[300, 2]:40 + W@[300, 3]:30 + W@[300, 4]:34 + W@[300, 5]:45 + W@[300, 6]:27 + W@[300, 7]:0",1003331,301,9,"W@[302, 1]:10 + W@[302, 2]:0 + W@[302, 3]:0 + W@[302, 4]:0 + W@[302, 5]:101 + W@[302, 6]:0 + W@[302, 7]:0 + <span style=""color:#F80000;"">HB@[302, 2, 1]:44</span> + <span style=""color:#F80000;"">HB@[302, 5, 1]:22</span>",2,2
26,1000096,AS069,84,False,False,1003468,324,7,"W@[325, 1]:0 + W@[325, 2]:35 + W@[325, 3]:10 + W@[325, 4]:0 + W@[325, 5]:31 + W@[325, 6]:8 + W@[325, 7]:0",1003452,340,8,"W@[341, 1]:0 + W@[341, 2]:43 + W@[341, 3]:0 + W@[341, 4]:0 + W@[341, 5]:21 + W@[341, 6]:0 + W@[341, 7]:0 + <span style=""color:#F80000;"">W@[341, 5, 1]:20</span>",16,1
27,1000096,AS069,44,False,False,1003462,330,7,"W@[331, 1]:0 + W@[331, 2]:11 + W@[331, 3]:20 + W@[331, 4]:0 + W@[331, 5]:13 + W@[331, 6]:0 + W@[331, 7]:0",1003440,406,7,"W@[407, 1]:0 + W@[407, 2]:33 + W@[407, 3]:0 + W@[407, 4]:1 + W@[407, 5]:10 + W@[407, 6]:0 + W@[407, 7]:0",76,0
28,1000096,AS069,26,False,False,1003412,380,7,"W@[381, 1]:0 + W@[381, 2]:13 + W@[381, 3]:0 + W@[381, 4]:0 + W@[381, 5]:13 + W@[381, 6]:0 + W@[381, 7]:0",1003400,392,7,"W@[393, 1]:0 + W@[393, 2]:24 + W@[393, 3]:0 + W@[393, 4]:0 + W@[393, 5]:0 + W@[393, 6]:0 + <span style=""color:#F80000;"">KB@[393, 2, 1]:2</span>",12,0
29,1000096,AS069,56,False,False,1003396,396,7,"W@[397, 1]:0 + W@[397, 2]:0 + W@[397, 3]:6 + W@[397, 4]:0 + W@[397, 5]:50 + W@[397, 6]:0 + W@[397, 7]:0",1003442,404,6,"W@[405, 1]:10 + W@[405, 2]:14 + W@[405, 3]:3 + W@[405, 4]:14 + W@[405, 5]:15 + W@[405, 6]:0",8,1
30,1000131,AS156,500,False,False,1004492,1,2,"B:GG:BB@[2, 1]:140 + W@[2, 2]:360",1004493,2,2,"B@[3, 1]:140 + B@[3, 2]:360",1,0
31,1000131,AS156,100,False,False,1004500,9,2,"B:GG:BB@[10, 1]:40 + W@[10, 2]:60",1004501,10,2,"B@[11, 1]:40 + B@[11, 2]:60",1,0
32,1000131,AS156,72,False,True,1004509,18,2,"B:GG:BB@[19, 1]:20 + W@[19, 2]:52",1004511,20,2,"B:GG:BB@[21, 1]:20 + W@[21, 2]:52",2,0
33,1000131,AS156,71,False,True,1004510,19,2,"B@[20, 1]:20 + B@[20, 2]:51",1004512,21,2,"B@[22, 1]:20 + B@[22, 2]:51",2,0
34,1000131,AS156,72,False,False,1004513,22,2,"B:GG:BB@[23, 1]:20 + W@[23, 2]:52",1004516,25,2,"B@[26, 1]:20 + B@[26, 2]:52",3,0
35,1000131,AS156,71,False,True,1004514,23,2,"B@[24, 1]:20 + B@[24, 2]:51",1004518,27,2,"B@[28, 1]:20 + B@[28, 2]:51",4,0
36,1000131,AS156,72,False,True,1004520,29,2,"B@[30, 1]:20 + B@[30, 2]:52",1004522,31,2,"B@[32, 1]:20 + B@[32, 2]:52",2,0
37,1000058,AS159,57,False,False,1002211,2,6,"B@[3, 1]:25 + W:B@[3, 2]:18 + <span style=""color:#F80000;"">GA@[3, 1, 1]:3</span> + <span style=""color:#F80000;"">W@[3, 1, 2]:4</span> + <span style=""color:#F80000;"">W@[3, 2, 1]:3</span> + <span style=""color:#F80000;"">GA@[3, 2, 2]:4</span>",1002216,7,8,"B@[8, 1]:10 + B@[8, 2]:7 + B@[8, 3]:7 + B@[8, 4]:13 + B@[8, 5]:6 + B@[8, 6]:3 + B@[8, 7]:7 + <span style=""color:#F80000;"">W:B@[8, 2, 1]:4</span>",5,2
38,1000145,AS171,25,False,False,1004753,4,2,"YB:G@[5, 1]:10 + YB:G@[5, 2]:15",1004757,8,2,"LB@[9, 1]:7 + G@[9, 2]:18",4,0
39,1000146,AS172,1000,False,False,1004763,1,2,"W@[2, 1]:400 + MB@[2, 2]:600",1004768,6,4,"W@[7, 1]:200 + W@[7, 2]:200 + <span style=""color:#F80000;"">MB@[7, 1, 1]:300</span> + <span style=""color:#F80000;"">MB@[7, 2, 1]:300</span>",5,2
40,1000060,AS174,33,False,False,1002239,1,4,"W@[2, 1]:3 + LB@[2, 2]:25 + <span style=""color:#F80000;"">W@[2, 1, 1]:4</span> + <span style=""color:#F80000;"">W:LB:DB@[2, 2, 1]:1</span>",1002240,2,4,"W@[3, 1]:3 + LB@[3, 2]:24 + <span style=""color:#F80000;"">W@[3, 1, 1]:5</span> + <span style=""color:#F80000;"">W:LB:DB@[3, 2, 1]:1</span>",1,0
41,1000060,AS174,22,False,False,1002241,3,3,"W@[4, 1]:3 + LB@[4, 2]:16 + <span style=""color:#F80000;"">W@[4, 1, 1]:3</span>",1002242,4,4,"W@[5, 1]:2 + LB@[5, 2]:14 + <span style=""color:#F80000;"">W@[5, 1, 1]:4</span> + <span style=""color:#F80000;"">W:LB:DB@[5, 2, 1]:2</span>",1,1
42,1000164,AS199,513,True,False,1005225,8,6,"MB@[9, 1]:55 + MB@[9, 2]:46 + MB@[9, 3]:214 + MB:FB@[9, 4]:57 + MB:FB@[9, 5]:44 + MB:FB@[9, 6]:97",1005226,9,1,"W:MB@[10, 1]:513",1,5
43,1000164,AS199,463,True,False,1005227,10,6,"W:FB@[11, 1]:64 + W:FB@[11, 2]:44 + W:FB@[11, 3]:55 + W:DB@[11, 4]:201 + W:DB@[11, 5]:46 + W:DB@[11, 6]:53",1005228,12,1,"W:DB@[13, 1]:463",2,5
44,1000164,AS199,196,True,False,1005229,11,6,"W:MB@[12, 1]:17 + W:MB@[12, 2]:0 + W:MB@[12, 3]:71 + W:FB@[12, 4]:21 + W:FB@[12, 5]:14 + W:FB@[12, 6]:73",1005230,13,1,"W@[14, 1]:196",2,5
45,1000164,AS199,489,True,False,1005231,14,7,"W@[15, 1]:56 + W@[15, 2]:55 + W@[15, 3]:219 + DB@[15, 4]:54 + MB@[15, 5]:80 + MB@[15, 6]:25 + <span style=""color:#F80000;"">W:MB@[15, 4, 1]:0</span>",1005232,15,1,"MB@[16, 1]:489",1,6
46,1000164,AS199,587,True,False,1005233,16,6,"MB:FB@[17, 1]:99 + MB:FB@[17, 2]:54 + MB:FB@[17, 3]:67 + W:FB@[17, 4]:232 + W:FB@[17, 5]:64 + B:FB@[17, 6]:71",1005234,17,1,"W:MB@[18, 1]:587",1,5
47,1000164,AS199,127,True,False,1005239,22,6,"W@[23, 1]:30 + W@[23, 2]:12 + W@[23, 3]:8 + MB:D0@[23, 4]:60 + MB:D0@[23, 5]:0 + MB:DB@[23, 6]:17",1005240,23,1,"D0@[24, 1]:127",1,5
48,1000034,AS212,22,False,False,1001739,10,9,"MB@[11, 1]:4 + W:B@[11, 2]:4 + B@[11, 3]:4 + GY@[11, 4]:4 + B@[11, 5]:2 + <span style=""color:#F80000;"">W@[11, 1, 1]:1</span> + <span style=""color:#F80000;"">W@[11, 2, 1]:1</span> + <span style=""color:#F80000;"">W:B@[11, 2, 2]:1</span> + <span style=""color:#F80000;"">GY@[11, 4, 1]:1</span>",1001740,11,10,"W@[12, 1]:5 + MB@[12, 2]:2 + W:B@[12, 3]:2 + B@[12, 4]:2 + GY@[12, 5]:2 + W:B@[12, 6]:1 + <span style=""color:#F80000;"">B@[12, 1, 1]:3</span> + <span style=""color:#F80000;"">W@[12, 2, 1]:2</span> + <span style=""color:#F80000;"">B@[12, 4, 1]:1</span> + <span style=""color:#F80000;"">W:B@[12, 6, 1]:2</span>",1,1
49,1000036,AS214,43,False,False,1001791,0,2,"LB@[1, 1]:30 + W@[1, 2]:13",1001792,1,6,"LB:TG@[2, 1]:10 + LB@[2, 2]:16 + W:LB@[2, 3]:4 + W@[2, 4]:5 + W@[2, 5]:5 + W@[2, 6]:3",1,4
50,1000422,HP003,273,False,False,1014746,0,7,"W@[1, 1]:83 + W%MB@[1, 2]:54 + RM@[1, 3]:34 + W%AB@[1, 4]:0 + W:MB@[1, 5]:100 + KB@[1, 6]:0 + <span style=""color:#F80000;"">W-AB@[1, 3, 1]:2</span>",1014750,4,7,"W@[5, 1]:88 + W:MB@[5, 2]:72 + RM@[5, 3]:42 + W%AB@[5, 4]:1 + W:MB@[5, 5]:70 + KB@[5, 6]:0 + <span style=""color:#F80000;"">KB@[5, 3, 1]:0</span>",4,0
51,1000449,HP030,5414,False,False,1015139,2,10,"W@[3, 1]:2000 + MB@[3, 2]:223 + W:MB@[3, 3]:372 + W:KB@[3, 4]:250 + MB@[3, 5]:490 + MB@[3, 6]:491 + MB@[3, 7]:551 + W%AB@[3, 8]:768 + MB@[3, 9]:269 + <span style=""color:#F80000;"">AB@[3, 4, 1]:0</span>",1015141,4,10,"MB@[5, 1]:2129 + YB@[5, 2]:166 + W:MB@[5, 3]:315 + W:KB@[5, 4]:180 + MB@[5, 5]:366 + W%AB@[5, 6]:401 + W@[5, 7]:620 + W%AB@[5, 8]:654 + AB@[5, 9]:140 + <span style=""color:#F80000;"">W:MB@[5, 9, 1]:443</span>",2,0
52,1000580,HP050,23,False,True,1018685,3,1,"W:AB@[4, 1]:23",1018687,5,1,"W:AB@[6, 1]:23",2,0
53,1000580,HP050,22,False,True,1018696,14,1,"W:AB@[15, 1]:22",1018698,16,1,"W:AB@[17, 1]:22",2,0
54,1000586,HP056,45,False,False,1018810,4,9,"MB@[5, 1]:1 + MB@[5, 2]:8 + MB@[5, 3]:7 + MB@[5, 4]:4 + MB@[5, 5]:4 + W:MG@[5, 6]:3 + TG@[5, 7]:5 + MB@[5, 8]:5 + MB@[5, 9]:8",1018811,5,9,"W@[6, 1]:2 + W@[6, 2]:2 + W@[6, 3]:3 + W@[6, 4]:4 + W@[6, 5]:2 + W:TG@[6, 6]:6 + W:TG@[6, 7]:7 + W@[6, 8]:3 + W@[6, 9]:16",1,0
55,1000625,JC001,27,False,False,1019615,0,4,"YB@[1, 1]:12 + R0@[1, 2]:10 + NB-DB@[1, 3]:3 + YB@[1, 4]:2",1019621,6,5,"DG@[7, 1]:10 + KB@[7, 2]:10 + NB@[7, 3]:3 + YB@[7, 4]:2 + DB@[7, 5]:2",6,1
56,1000625,JC001,125,False,False,1019616,1,4,"DG@[2, 1]:62 + R0@[2, 2]:60 + PG-RM@[2, 3]:2 + YB@[2, 4]:1",1019622,7,4,"YB-KB@[8, 1]:62 + R0@[8, 2]:60 + DB@[8, 3]:2 + YB@[8, 4]:1",6,0
57,1000634,JC010,41,False,False,1019664,9,11,"AB@[10, 1]:17 + MB@[10, 2]:0 + MB@[10, 3]:0 + AB@[10, 4]:3 + AB@[10, 5]:0 + AB@[10, 6]:1 + NB@[10, 7]:0 + AB-MB@[10, 8]:0 + AB-NB@[10, 9]:0 + W@[10, 10]:10 + AB:MB@[10, 11]:10",1019665,10,11,"W@[11, 1]:14 + MB@[11, 2]:0 + MB@[11, 3]:2 + AB@[11, 4]:3 + AB@[11, 5]:0 + MB@[11, 6]:0 + NB@[11, 7]:0 + NB-MB@[11, 8]:0 + AB-MB@[11, 9]:1 + W@[11, 10]:10 + MB@[11, 11]:11",1,0
58,1000020,UR003,51,False,False,1000847,5,33,"W@[6, 1]:3 + W@[6, 2]:2 + W:MB@[6, 3]:1 + W:KB@[6, 4]:0 + W@[6, 5]:0 + W@[6, 6]:1 + W@[6, 7]:2 + W@[6, 8]:2 + W@[6, 9]:1 + W@[6, 10]:0 + <span style=""color:#F80000;"">KB@[6, 1, 1]:1</span> + <span style=""color:#F80000;"">KB@[6, 1, 2]:3</span> + <span style=""color:#F80000;"">KB@[6, 1, 3]:2</span> + <span style=""color:#F80000;"">RL@[6, 1, 4]:0</span> + <span style=""color:#F80000;"">KB@[6, 1, 4, 1]:1</span> + <span style=""color:#F80000;"">LC@[6, 1, 6]:4</span> + <span style=""color:#F80000;"">MB@[6, 1, 6, 1]:1</span> + <span style=""color:#F80000;"">W:AB@[6, 1, 6, 2]:1</span> + <span style=""color:#F80000;"">KB@[6, 1, 6, 3]:1</span> + <span style=""color:#F80000;"">WMB@[6, 1, 10]:1</span> + <span style=""color:#F80000;"">KB@[6, 1, 11]:1</span> + <span style=""color:#F80000;"">W-KB@[6, 3, 1]:1</span> + <span style=""color:#F80000;"">MB@[6, 5, 1]:1</span> + <span style=""color:#F80000;"">MB@[6, 5, 2]:1</span> + <span style=""color:#F80000;"">AB@[6, 6, 1]:0</span> + <span style=""color:#F80000;"">PK@[6, 6, 1, 1]:1</span> + <span style=""color:#F80000;"">@[6, 6, 1, 1, 1]:0</span> + <span style=""color:#F80000;"">W:KB@[6, 8, 1]:1</span> + <span style=""color:#F80000;"">W:AB@[6, 9, 1]:1</span> + <span style=""color:#F80000;"">W:AB@[6, 9, 2]:1</span> + <span style=""color:#F80000;"">LC@[6, 10, 1]:9</span> + <span style=""color:#F80000;"">MB@[6, 10, 2]:4</span> + <span style=""color:#F80000;"">LC@[6, 10, 3]:3</span>",1014469,10,45,"W:MB@[11, 1]:0 + W@[11, 2]:0 + W@[11, 3]:2 + W@[11, 4]:1 + W@[11, 5]:4 + W@[11, 6]:0 + W@[11, 7]:1 + MB@[11, 8]:1 + @[11, 9]:0 + W:RL@[11, 10]:0 + MB@[11, 11]:0 + MB@[11, 12]:0 + MB@[11, 13]:1 + MB@[11, 14]:0 + MB@[11, 15]:0 + W@[11, 16]:1 + MB@[11, 17]:1 + MB@[11, 18]:1 + <span style=""color:#F80000;"">W-KB@[11, 6, 1]:1</span> + <span style=""color:#F80000;"">GG@[11, 7, 1]:4</span> + <span style=""color:#F80000;"">MB@[11, 7, 2]:4</span> + <span style=""color:#F80000;"">MB:LC@[11, 7, 3]:1</span> + <span style=""color:#F80000;"">W-AB@[11, 8, 1]:0</span> + <span style=""color:#F80000;"">MB:LC@[11, 8, 1, 1]:0</span> + <span style=""color:#F80000;"">W:AB@[11, 8, 3]:0</span> + <span style=""color:#F80000;"">AB@[11, 8, 4]:1</span> + <span style=""color:#F80000;"">RL@[11, 8, 5]:0</span> + <span style=""color:#F80000;"">MB@[11, 8, 6]:7</span> + <span style=""color:#F80000;"">W-AB@[11, 9, 1]:1</span> + <span style=""color:#F80000;"">AB@[11, 10, 1]:3</span> + <span style=""color:#F80000;"">RL@[11, 11, 1]:0</span> + <span style=""color:#F80000;"">MB@[11, 11, 2]:1</span> + <span style=""color:#F80000;"">AB@[11, 11, 3]:0</span> + <span style=""color:#F80000;"">W@[11, 11, 4]:1</span> + <span style=""color:#F80000;"">W:RL@[11, 11, 5]:0</span> + <span style=""color:#F80000;"">W-AB@[11, 12, 1]:1</span> + <span style=""color:#F80000;"">RL@[11, 17, 1]:5</span> + <span style=""color:#F80000;"">MB@[11, 17, 2]:1</span> + <span style=""color:#F80000;"">W@[11, 17, 3]:0</span> + <span style=""color:#F80000;"">GG@[11, 17, 4]:3</span> + <span style=""color:#F80000;"">W@[11, 18, 1]:0</span> + <span style=""color:#F80000;"">W:RL@[11, 18, 2]:1</span> + <span style=""color:#F80000;"">W:RL@[11, 18, 3]:0</span> + <span style=""color:#F80000;"">MB:LC@[11, 18, 3, 1]:2</span> + <span style=""color:#F80000;"">W:AB@[11, 18, 5]:1</span>",5,12
59,1000025,UR006,58,False,False,1001134,5,31,"MB@[6, 1]:0 + AB@[6, 2]:1 + AB:MB@[6, 3]:0 + RB@[6, 4]:0 + MB@[6, 5]:0 + AB@[6, 6]:0 + MB:KB@[6, 7]:0 + RB@[6, 8]:0 + MB@[6, 9]:0 + AB@[6, 10]:0 + AB:MB@[6, 11]:0 + MB@[6, 12]:3 + MB@[6, 13]:1 + AB@[6, 14]:1 + AB:KB@[6, 15]:1 + MB@[6, 16]:0 + KB@[6, 17]:15 + GG@[6, 18]:0 + AB:GG@[6, 19]:3 + KB@[6, 20]:4 + AB:KB@[6, 21]:0 + <span style=""color:#F80000;"">MB@[6, 12, 1]:1</span> + <span style=""color:#F80000;"">MB@[6, 13, 1]:3</span> + <span style=""color:#F80000;"">MB@[6, 13, 2]:2</span> + <span style=""color:#F80000;"">AB@[6, 14, 1]:1</span> + <span style=""color:#F80000;"">AB@[6, 14, 2]:2</span> + <span style=""color:#F80000;"">MB@[6, 16, 1]:12</span> + <span style=""color:#F80000;"">MB@[6, 16, 1, 1]:2</span> + <span style=""color:#F80000;"">KB@[6, 17, 1]:3</span> + <span style=""color:#F80000;"">MB@[6, 19, 1]:2</span> + <span style=""color:#F80000;"">KB@[6, 20, 1]:1</span>",1001146,12,21,"MB@[13, 1]:0 + AB@[13, 2]:1 + MB:RB@[13, 3]:0 + RB@[13, 4]:1 + MB@[13, 5]:2 + AB@[13, 6]:2 + AB:RB@[13, 7]:2 + RB@[13, 8]:7 + MB@[13, 9]:0 + AB@[13, 10]:1 + AB:RB@[13, 11]:1 + RB@[13, 12]:10 + MB@[13, 13]:3 + AB@[13, 14]:7 + AB:RB@[13, 15]:3 + RB@[13, 16]:2 + KB@[13, 17]:2 + GG@[13, 18]:0 + AB:GG@[13, 19]:0 + KB@[13, 20]:0 + AB:KB@[13, 21]:14",7,10
60,1000025,UR006,52,False,False,1001144,10,27,"MB@[11, 1]:0 + AB@[11, 2]:0 + MB:KB@[11, 3]:0 + MB@[11, 4]:1 + MB@[11, 5]:0 + AB@[11, 6]:1 + AB:MB@[11, 7]:0 + MB@[11, 8]:1 + MB@[11, 9]:0 + AB@[11, 10]:6 + AB:MB@[11, 11]:0 + MB@[11, 12]:2 + MB@[11, 13]:0 + MB@[11, 14]:1 + MB:KB@[11, 15]:0 + MB@[11, 16]:3 + MB@[11, 17]:9 + GG@[11, 18]:0 + AB:GG@[11, 19]:5 + KB@[11, 20]:9 + AB:KB@[11, 21]:2 + <span style=""color:#F80000;"">AB@[11, 10, 1]:1</span> + <span style=""color:#F80000;"">MB@[11, 12, 1]:1</span> + <span style=""color:#F80000;"">MB@[11, 16, 1]:4</span> + <span style=""color:#F80000;"">KB@[11, 17, 1]:2</span> + <span style=""color:#F80000;"">MB@[11, 19, 1]:2</span> + <span style=""color:#F80000;"">GG@[11, 20, 1]:2</span>",1001164,30,24,"VR@[31, 1]:0 + MB@[31, 2]:0 + MB@[31, 3]:2 + MB@[31, 4]:0 + MB@[31, 5]:1 + VR@[31, 6]:0 + MB@[31, 7]:0 + MB@[31, 8]:0 + MB@[31, 9]:0 + MB@[31, 10]:3 + MB@[31, 11]:0 + MB@[31, 12]:2 + MB@[31, 13]:0 + MB@[31, 14]:3 + MB@[31, 15]:0 + MB@[31, 16]:2 + MB@[31, 17]:1 + KB@[31, 18]:0 + KB@[31, 19]:16 + AB:MB@[31, 20]:4 + MB@[31, 21]:2 + AB:GG@[31, 22]:1 + <span style=""color:#F80000;"">MB@[31, 15, 1]:1</span> + <span style=""color:#F80000;"">MB@[31, 18, 1]:14</span>",20,3
61,1000025,UR006,71,False,False,1001158,24,24,"MB@[25, 1]:0 + MB@[25, 2]:2 + MB@[25, 3]:0 + MB@[25, 4]:2 + VR@[25, 5]:0 + MB@[25, 6]:1 + MB@[25, 7]:0 + MB@[25, 8]:1 + MB@[25, 9]:3 + MB@[25, 10]:0 + MB@[25, 11]:3 + MB@[25, 12]:1 + MB@[25, 13]:13 + MB@[25, 14]:0 + MB@[25, 15]:3 + MB@[25, 16]:0 + MB@[25, 17]:0 + MB@[25, 18]:10 + MB@[25, 19]:9 + KB@[25, 20]:10 + AB:GG@[25, 21]:5 + <span style=""color:#F80000;"">MB@[25, 14, 1]:1</span> + <span style=""color:#F80000;"">MB@[25, 15, 1]:4</span> + <span style=""color:#F80000;"">MB@[25, 17, 1]:3</span>",1001160,26,22,"VR@[27, 1]:0 + MB@[27, 2]:0 + AB@[27, 3]:2 + MB@[27, 4]:0 + MB@[27, 5]:1 + VR@[27, 6]:2 + MB@[27, 7]:0 + AB@[27, 8]:2 + MB@[27, 9]:0 + MB@[27, 10]:1 + MB@[27, 11]:2 + AB@[27, 12]:10 + MB@[27, 13]:1 + MB@[27, 14]:7 + MB@[27, 15]:1 + AB@[27, 16]:1 + MB@[27, 17]:0 + MB@[27, 18]:6 + KB@[27, 19]:10 + MB@[27, 20]:5 + MB@[27, 21]:15 + AB:GG@[27, 22]:5",2,2
62,1000025,UR006,26,False,False,1001172,38,22,"VR@[39, 1]:0 + MB@[39, 2]:0 + MB@[39, 3]:1 + MB@[39, 4]:0 + MB@[39, 5]:1 + VR@[39, 6]:0 + MB@[39, 7]:0 + MB@[39, 8]:1 + MB@[39, 9]:1 + MB@[39, 10]:2 + MB@[39, 11]:0 + MB@[39, 12]:2 + MB@[39, 13]:0 + MB@[39, 14]:3 + MB@[39, 15]:2 + MB@[39, 16]:2 + MB@[39, 17]:2 + MB@[39, 18]:5 + MB:KB@[39, 19]:4 + MB@[39, 20]:0 + KB@[39, 21]:0 + AB:GG@[39, 22]:0",1001174,40,25,"VR@[41, 1]:0 + MB@[41, 2]:0 + MB@[41, 3]:0 + MB@[41, 4]:1 + MB@[41, 5]:0 + VR@[41, 6]:0 + MB@[41, 7]:0 + MB@[41, 8]:1 + MB@[41, 9]:0 + MB@[41, 10]:1 + MB@[41, 11]:0 + MB@[41, 12]:1 + MB@[41, 13]:0 + MB@[41, 14]:2 + MB@[41, 15]:1 + MB@[41, 16]:0 + MB@[41, 17]:0 + KB@[41, 18]:2 + KB@[41, 19]:5 + MB@[41, 20]:2 + KB@[41, 21]:5 + AB:GG@[41, 22]:0 + <span style=""color:#F80000;"">MB@[41, 15, 1]:2</span> + <span style=""color:#F80000;"">MB@[41, 16, 1]:1</span> + <span style=""color:#F80000;"">MB@[41, 18, 1]:2</span>",2,3
63,1000004,UR010,126,False,False,1000047,7,5,"W@[8, 1]:15 + W@[8, 2]:21 + W@[8, 3]:60 + AB@[8, 4]:10 + W@[8, 5]:20",1000051,11,11,"AB@[12, 1]:71 + W@[12, 2]:8 + MB@[12, 3]:0 + MB@[12, 4]:24 + AB:MB@[12, 5]:2 + W@[12, 6]:0 + W:AB@[12, 7]:5 + AB:MB@[12, 8]:7 + RL:GG@[12, 9]:3 + <span style=""color:#F80000;"">W@[12, 4, 1]:4</span> + <span style=""color:#F80000;"">W:MB@[12, 9, 1]:2</span>",4,6
64,1000004,UR010,115,False,False,1000048,8,7,"AB@[9, 1]:16 + W-RL@[9, 2]:19 + AB@[9, 3]:25 + AB@[9, 4]:11 + AB@[9, 5]:16 + AB@[9, 6]:11 + AB@[9, 7]:17",1000050,10,9,"W:KB@[11, 1]:14 + W@[11, 2]:16 + GG@[11, 3]:24 + AB@[11, 4]:17 + AB@[11, 5]:15 + W@[11, 6]:11 + MB@[11, 7]:16 + W@[11, 8]:0 + W@[11, 9]:2",2,2
65,1000004,UR010,112,False,False,1000055,15,1,"W@[16, 1]:112",1000056,16,7,"KB@[17, 1]:2 + W@[17, 2]:40 + W@[17, 3]:48 + W@[17, 4]:6 + W@[17, 5]:6 + W@[17, 6]:5 + AB:GG@[17, 7]:5",1,6
66,1000004,UR010,106,False,False,1000058,18,1,"W@[19, 1]:106",1000062,22,9,"W@[23, 1]:6 + KB@[23, 2]:22 + W@[23, 3]:28 + W@[23, 4]:34 + W@[23, 5]:0 + AB:GG@[23, 6]:3 + KB@[23, 7]:3 + AB:KB@[23, 8]:8 + AB@[23, 9]:2",4,8
67,1000004,UR010,92,False,False,1000063,23,6,"W@[24, 1]:7 + W@[24, 2]:12 + AB@[24, 3]:20 + AB@[24, 4]:12 + W@[24, 5]:16 + KB@[24, 6]:25",1000067,27,1,"GG@[28, 1]:92",4,5
68,1000045,UR022,144,False,False,1001937,15,10,"W@[16, 1]:54 + W@[16, 2]:15 + W@[16, 3]:4 + W@[16, 4]:6 + W@[16, 5]:0 + W@[16, 6]:0 + W@[16, 7]:2 + W@[16, 8]:10 + W@[16, 9]:30 + W@[16, 10]:23",1001931,21,9,"W@[22, 1]:61 + W@[22, 2]:40 + W@[22, 3]:0 + W@[22, 4]:0 + W@[22, 5]:10 + AB@[22, 6]:7 + W@[22, 7]:0 + W@[22, 8]:26 + W@[22, 9]:0",6,1
69,1000304,UR028,102,False,False,1008430,0,1,"AB@[1, 1]:102",1008431,1,6,"AB@[2, 1]:29 + AB@[2, 2]:13 + AB@[2, 3]:12 + <span style=""color:#F80000;"">MB@[2, 1, 1]:14</span> + <span style=""color:#F80000;"">MB@[2, 2, 1]:10</span> + <span style=""color:#F80000;"">MB@[2, 3, 1]:24</span>",1,5
70,1000380,UR034,36,False,False,1013700,3,4,"W@[4, 1]:14 + <span style=""color:#F80000;"">AB@[4, 1, 1]:3</span> + <span style=""color:#F80000;"">W@[4, 1, 2]:15</span> + <span style=""color:#F80000;"">AB@[4, 1, 2, 1]:4</span>",1013708,11,3,"W:MB@[12, 1]:10 + LA@[12, 2]:6 + W@[12, 3]:20",8,1
71,1000380,UR034,38,False,False,1013718,21,6,"W@[22, 1]:5 + <span style=""color:#F80000;"">W@[22, 1, 1]:4</span> + <span style=""color:#F80000;"">AB@[22, 1, 1, 1]:5</span> + <span style=""color:#F80000;"">AB@[22, 1, 1, 2]:20</span> + <span style=""color:#F80000;"">RL@[22, 1, 4]:3</span> + <span style=""color:#F80000;"">W@[22, 1, 5]:1</span>",1013722,25,7,"W@[26, 1]:5 + <span style=""color:#F80000;"">W@[26, 1, 1]:4</span> + <span style=""color:#F80000;"">W@[26, 1, 1, 1]:4</span> + <span style=""color:#F80000;"">W:AB@[26, 1, 1, 2]:20</span> + <span style=""color:#F80000;"">RL@[26, 1, 4]:3</span> + <span style=""color:#F80000;"">W:AB@[26, 1, 5]:1</span> + <span style=""color:#F80000;"">W@[26, 1, 6]:1</span>",4,1
72,1000331,UR037,24,False,False,1012402,13,12,"AB@[14, 1]:2 + W@[14, 2]:2 + W@[14, 3]:2 + AB@[14, 4]:4 + AB@[14, 5]:2 + AB@[14, 6]:2 + W@[14, 7]:0 + MB@[14, 8]:2 + AB@[14, 9]:2 + AB@[14, 10]:2 + AB@[14, 11]:2 + BG@[14, 12]:2",1012404,15,9,"W@[16, 1]:4 + W@[16, 2]:2 + AB@[16, 3]:4 + AB@[16, 4]:4 + MB@[16, 5]:2 + AB@[16, 6]:2 + AB@[16, 7]:2 + AB@[16, 8]:2 + BG@[16, 9]:2",2,3
73,1000332,UR045,23,False,False,1012438,20,7,"AB@[21, 1]:2 + AB@[21, 2]:2 + AB@[21, 3]:14 + AB@[21, 4]:1 + <span style=""color:#F80000;"">AB@[21, 1, 1]:1</span> + <span style=""color:#F80000;"">W:AB@[21, 1, 2]:3</span> + <span style=""color:#F80000;"">AB@[21, 1, 3]:0</span>",1012439,21,5,"MB@[22, 1]:7 + MB@[22, 2]:2 + MB@[22, 3]:12 + MB@[22, 4]:1 + <span style=""color:#F80000;"">AB@[22, 1, 1]:1</span>",1,2
74,1000240,UR047,100,False,False,1006434,3,10,"W@[4, 1]:10 + PK@[4, 2]:10 + PK@[4, 3]:10 + PK@[4, 4]:10 + MB@[4, 5]:10 + MB@[4, 6]:10 + W@[4, 7]:10 + MB@[4, 8]:10 + W@[4, 9]:10 + W@[4, 10]:10",1006436,5,10,"W@[6, 1]:10 + W@[6, 2]:10 + W@[6, 3]:10 + W@[6, 4]:10 + W@[6, 5]:10 + W@[6, 6]:10 + W@[6, 7]:10 + W@[6, 8]:10 + W@[6, 9]:10 + W@[6, 10]:10",2,0
75,1000240,UR047,100,True,False,1006437,6,1,"W@[7, 1]:100",1006438,7,10,"W@[8, 1]:10 + W@[8, 2]:10 + W@[8, 3]:10 + W@[8, 4]:10 + W@[8, 5]:10 + W@[8, 6]:10 + W:AB@[8, 7]:10 + W:AB@[8, 8]:10 + W:AB@[8, 9]:10 + W:AB@[8, 10]:10",1,9
76,1000238,UR049,45,False,False,1006325,0,7,"YB@[1, 1]:15 + YB@[1, 2]:10 + YB@[1, 3]:0 + YB@[1, 4]:20 + YB@[1, 5]:0 + YB@[1, 6]:0 + YB@[1, 7]:0",1006344,19,3,"HB@[20, 1]:12 + HB@[20, 2]:13 + HB@[20, 3]:20",19,4
77,1000238,UR049,25,False,False,1006330,5,5,"MB@[6, 1]:10 + MB@[6, 2]:0 + MB@[6, 3]:5 + MB@[6, 4]:0 + MB@[6, 5]:10",1006353,28,1,"MB-KB@[29, 1]:25",23,4
78,1000336,UR086,213,False,False,1012702,0,7,"KB@[1, 1]:0 + AB@[1, 2]:8 + AB@[1, 3]:38 + B@[1, 4]:22 + KB@[1, 5]:0 + W@[1, 6]:80 + AB@[1, 7]:65",1012718,16,8,"W-AB@[17, 1]:2 + AB:MB@[17, 2]:10 + W:MB@[17, 3]:26 + W@[17, 4]:17 + W@[17, 5]:53 + W:AB@[17, 6]:45 + B@[17, 7]:30 + W@[17, 8]:30",16,1
79,1000336,UR086,58,False,False,1012711,9,4,"W:AB@[10, 1]:3 + B@[10, 2]:0 + W@[10, 3]:29 + AB@[10, 4]:26",1012713,11,3,"W:AB@[12, 1]:6 + W@[12, 2]:46 + AB@[12, 3]:6",2,1
80,1000273,UR087,21,True,False,1006822,3,1,"AB@[4, 1]:21",1006829,10,8,"YB@[11, 1]:1 + YB@[11, 2]:1 + YB@[11, 3]:2 + YB@[11, 4]:11 + YB@[11, 5]:1 + YB@[11, 6]:2 + <span style=""color:#F80000;"">LG@[11, 2, 1]:2</span> + <span style=""color:#F80000;"">AB:MB@[11, 3, 1]:1</span>",7,7
81,1000273,UR087,22,True,False,1006831,12,9,"AB@[13, 1]:1 + AB@[13, 2]:1 + AB@[13, 3]:1 + AB@[13, 4]:11 + AB@[13, 5]:2 + AB@[13, 6]:1 + <span style=""color:#F80000;"">LG@[13, 2, 1]:3</span> + <span style=""color:#F80000;"">AB:MB@[13, 3, 1]:1</span> + <span style=""color:#F80000;"">AB:KB@[13, 4, 1]:1</span>",1006832,13,1,"YB@[14, 1]:22",1,8
82,1000273,UR087,27,False,False,1006835,16,8,"AB@[17, 1]:1 + AB@[17, 2]:1 + AB@[17, 3]:1 + AB@[17, 4]:13 + AB@[17, 5]:1 + AB@[17, 6]:7 + <span style=""color:#F80000;"">AB:MB@[17, 3, 1]:1</span> + <span style=""color:#F80000;"">W:KB@[17, 4, 1]:2</span>",1006849,30,7,"AB@[31, 1]:1 + AB@[31, 2]:0 + AB@[31, 3]:1 + AB@[31, 4]:20 + AB@[31, 5]:2 + AB@[31, 6]:2 + <span style=""color:#F80000;"">W:KB@[31, 2, 1]:1</span>",14,1
83,1000273,UR087,22,False,False,1006837,18,9,"RB@[19, 1]:1 + RB@[19, 2]:3 + RB@[19, 3]:1 + RB@[19, 4]:11 + RB@[19, 5]:1 + RB@[19, 6]:1 + <span style=""color:#F80000;"">W:AB@[19, 3, 1]:2</span> + <span style=""color:#F80000;"">W:KB@[19, 4, 1]:1</span> + <span style=""color:#F80000;"">LG:AB@[19, 5, 1]:1</span>",1006848,29,9,"YB@[30, 1]:1 + YB@[30, 2]:0 + YB@[30, 3]:0 + YB@[30, 4]:5 + YB@[30, 5]:2 + YB@[30, 6]:2 + <span style=""color:#F80000;"">W:KB@[30, 2, 1]:1</span> + <span style=""color:#F80000;"">W:AB@[30, 3, 1]:4</span> + <span style=""color:#F80000;"">W:KB@[30, 4, 1]:7</span>",11,0
84,1000273,UR087,21,False,False,1006846,27,7,"YB@[28, 1]:1 + YB@[28, 2]:2 + YB@[28, 3]:1 + YB@[28, 4]:12 + YB@[28, 5]:1 + YB@[28, 6]:1 + <span style=""color:#F80000;"">W:AB@[28, 3, 1]:3</span>",1006862,43,7,"AB@[44, 1]:1 + AB@[44, 2]:3 + AB@[44, 3]:0 + AB@[44, 4]:12 + AB@[44, 5]:1 + AB@[44, 6]:1 + <span style=""color:#F80000;"">W:AB@[44, 3, 1]:3</span>",16,0
85,1000273,UR087,22,False,False,1006858,39,7,"YB@[40, 1]:1 + YB@[40, 2]:3 + YB@[40, 3]:1 + YB@[40, 4]:11 + YB@[40, 5]:1 + YB@[40, 6]:1 + <span style=""color:#F80000;"">W:BY@[40, 3, 1]:4</span>",1006863,44,7,"YB@[45, 1]:1 + YB@[45, 2]:3 + YB@[45, 3]:1 + YB@[45, 4]:12 + YB@[45, 5]:1 + YB@[45, 6]:3 + <span style=""color:#F80000;"">W:KB@[45, 2, 1]:1</span>",5,0
86,1000275,UR089,114,False,False,1006958,0,10,"AB:G0@[1, 1]:4 + AB:G0@[1, 2]:22 + AB:G0@[1, 3]:6 + AB:G0@[1, 4]:60 + AB:G0@[1, 5]:0 + AB:G0@[1, 6]:4 + <span style=""color:#F80000;"">AB@[1, 2, 1]:3</span> + <span style=""color:#F80000;"">W@[1, 3, 1]:0</span> + <span style=""color:#F80000;"">W:AB@[1, 3, 2]:14</span> + <span style=""color:#F80000;"">W:KB@[1, 4, 1]:1</span>",1006961,3,9,"MB@[4, 1]:4 + MB@[4, 2]:22 + MB@[4, 3]:3 + MB@[4, 4]:59 + MB@[4, 5]:5 + MB@[4, 6]:4 + <span style=""color:#F80000;"">W@[4, 3, 1]:0</span> + <span style=""color:#F80000;"">W:AB@[4, 3, 2]:14</span> + <span style=""color:#F80000;"">MB:KB@[4, 4, 1]:3</span>",3,1
87,1000321,UR093,82,False,False,1012029,3,59,"W@[4, 1]:0 + YB@[4, 2]:36 + RB@[4, 3]:3 + AB@[4, 4]:0 + W:AB@[4, 5]:0 + YB@[4, 6]:0 + AB@[4, 7]:0 + AB:KB@[4, 8]:0 + W@[4, 9]:0 + AB-MB@[4, 10]:0 + W-AB-GG@[4, 11]:1 + GG@[4, 12]:0 + W@[4, 13]:1 + W@[4, 14]:0 + W:MB@[4, 15]:0 + W@[4, 16]:2 + GG@[4, 17]:0 + GG@[4, 18]:1 + <span style=""color:#F80000;"">W@[4, 2, 1]:3</span> + <span style=""color:#F80000;"">W@[4, 2, 2]:8</span> + <span style=""color:#F80000;"">W@[4, 2, 3]:1</span> + <span style=""color:#F80000;"">W@[4, 2, 4]:5</span> + <span style=""color:#F80000;"">W@[4, 2, 5]:10</span> + <span style=""color:#F80000;"">BG@[4, 2, 6]:2</span> + <span style=""color:#F80000;"">W:LC@[4, 2, 7]:1</span> + <span style=""color:#F80000;"">W@[4, 2, 8]:6</span> + <span style=""color:#F80000;"">W@[4, 3, 1]:0</span> + <span style=""color:#F80000;"">W@[4, 3, 2]:0</span> + <span style=""color:#F80000;"">W@[4, 3, 3]:0</span> + <span style=""color:#F80000;"">W@[4, 3, 4]:0</span> + <span style=""color:#F80000;"">W@[4, 3, 5]:0</span> + <span style=""color:#F80000;"">BG@[4, 3, 6]:0</span> + <span style=""color:#F80000;"">W:BG@[4, 3, 7]:0</span> + <span style=""color:#F80000;"">W@[4, 3, 8]:0</span> + <span style=""color:#F80000;"">W@[4, 10, 1]:0</span> + <span style=""color:#F80000;"">W@[4, 10, 2]:0</span> + <span style=""color:#F80000;"">W@[4, 10, 3]:0</span> + <span style=""color:#F80000;"">W@[4, 10, 4]:0</span> + <span style=""color:#F80000;"">W@[4, 10, 5]:0</span> + <span style=""color:#F80000;"">VB@[4, 10, 6]:0</span> + <span style=""color:#F80000;"">W:VB@[4, 10, 7]:0</span> + <span style=""color:#F80000;"">W@[4, 10, 8]:0</span> + <span style=""color:#F80000;"">W@[4, 10, 9]:0</span> + <span style=""color:#F80000;"">W@[4, 11, 1]:0</span> + <span style=""color:#F80000;"">W@[4, 11, 2]:0</span> + <span style=""color:#F80000;"">W@[4, 11, 3]:1</span> + <span style=""color:#F80000;"">W@[4, 11, 4]:0</span> + <span style=""color:#F80000;"">W@[4, 11, 5]:0</span> + <span style=""color:#F80000;"">LG@[4, 11, 6]:0</span> + <span style=""color:#F80000;"">W:BG@[4, 11, 7]:0</span> + <span style=""color:#F80000;"">W@[4, 11, 8]:0</span> + <span style=""color:#F80000;"">W@[4, 13, 1]:0</span> + <span style=""color:#F80000;"">W@[4, 13, 2]:0</span> + <span style=""color:#F80000;"">W@[4, 13, 3]:0</span> + <span style=""color:#F80000;"">W@[4, 13, 4]:1</span> + <span style=""color:#F80000;"">W@[4, 13, 5]:0</span> + <span style=""color:#F80000;"">BG@[4, 13, 6]:0</span> + <span style=""color:#F80000;"">W:BG@[4, 13, 7]:0</span> + <span style=""color:#F80000;"">W@[4, 13, 8]:0</span>",1012032,6,104,"VB@[7, 1]:6 + W@[7, 2]:20 + RB@[7, 3]:3 + HB@[7, 4]:3 + AB-GG@[7, 5]:0 + PK@[7, 6]:1 + W@[7, 7]:1 + W@[7, 8]:2 + BG@[7, 9]:2 + W@[7, 10]:2 + BG@[7, 11]:1 + GG@[7, 12]:1 + W@[7, 13]:1 + MB@[7, 14]:1 + W@[7, 15]:1 + AB@[7, 16]:10 + <span style=""color:#F80000;"">W@[7, 1, 1]:0</span> + <span style=""color:#F80000;"">W@[7, 1, 2]:0</span> + <span style=""color:#F80000;"">W@[7, 1, 3]:0</span> + <span style=""color:#F80000;"">W@[7, 1, 4]:0</span> + <span style=""color:#F80000;"">W@[7, 1, 5]:0</span> + <span style=""color:#F80000;"">LG@[7, 1, 6]:0</span> + <span style=""color:#F80000;"">W:BG@[7, 1, 7]:0</span> + <span style=""color:#F80000;"">W@[7, 1, 8]:0</span> + <span style=""color:#F80000;"">W@[7, 2, 1]:3</span> + <span style=""color:#F80000;"">W@[7, 2, 2]:3</span> + <span style=""color:#F80000;"">W@[7, 2, 3]:1</span> + <span style=""color:#F80000;"">W@[7, 2, 4]:5</span> + <span style=""color:#F80000;"">W@[7, 2, 5]:3</span> + <span style=""color:#F80000;"">BG@[7, 2, 6]:3</span> + <span style=""color:#F80000;"">W:BG@[7, 2, 7]:4</span> + <span style=""color:#F80000;"">W@[7, 2, 8]:4</span> + <span style=""color:#F80000;"">W@[7, 5, 1]:0</span> + <span style=""color:#F80000;"">W@[7, 5, 2]:0</span> + <span style=""color:#F80000;"">W@[7, 5, 3]:0</span> + <span style=""color:#F80000;"">W@[7, 5, 4]:0</span> + <span style=""color:#F80000;"">W@[7, 5, 5]:0</span> + <span style=""color:#F80000;"">BG@[7, 5, 6]:0</span> + <span style=""color:#F80000;"">W:PB@[7, 5, 7]:1</span> + <span style=""color:#F80000;"">W@[7, 5, 8]:0</span> + <span style=""color:#F80000;"">W@[7, 6, 1]:0</span> + <span style=""color:#F80000;"">W@[7, 6, 2]:0</span> + <span style=""color:#F80000;"">W@[7, 6, 3]:0</span> + <span style=""color:#F80000;"">W@[7, 6, 4]:0</span> + <span style=""color:#F80000;"">W@[7, 6, 5]:0</span> + <span style=""color:#F80000;"">GG@[7, 6, 6]:0</span> + <span style=""color:#F80000;"">W:YG@[7, 6, 7]:0</span> + <span style=""color:#F80000;"">W@[7, 6, 8]:0</span> + <span style=""color:#F80000;"">W@[7, 7, 1]:0</span> + <span style=""color:#F80000;"">W@[7, 7, 2]:0</span> + <span style=""color:#F80000;"">W@[7, 7, 3]:0</span> + <span style=""color:#F80000;"">W@[7, 7, 4]:0</span> + <span style=""color:#F80000;"">W@[7, 7, 5]:0</span> + <span style=""color:#F80000;"">W:BG@[7, 7, 6]:0</span> + <span style=""color:#F80000;"">W:BG@[7, 7, 7]:0</span> + <span style=""color:#F80000;"">W@[7, 7, 8]:0</span> + <span style=""color:#F80000;"">W@[7, 8, 1]:0</span> + <span style=""color:#F80000;"">W@[7, 8, 2]:0</span> + <span style=""color:#F80000;"">W@[7, 8, 3]:0</span> + <span style=""color:#F80000;"">W@[7, 8, 4]:0</span> + <span style=""color:#F80000;"">W@[7, 8, 5]:0</span> + <span style=""color:#F80000;"">B:BG@[7, 8, 6]:0</span> + <span style=""color:#F80000;"">W:BG@[7, 8, 7]:0</span> + <span style=""color:#F80000;"">W@[7, 8, 8]:0</span> + <span style=""color:#F80000;"">W@[7, 9, 1]:0</span> + <span style=""color:#F80000;"">W@[7, 9, 2]:0</span> + <span style=""color:#F80000;"">W@[7, 9, 3]:0</span> + <span style=""color:#F80000;"">W@[7, 9, 4]:0</span> + <span style=""color:#F80000;"">W@[7, 9, 5]:0</span> + <span style=""color:#F80000;"">BG@[7, 9, 6]:0</span> + <span style=""color:#F80000;"">W:BL@[7, 9, 7]:0</span> + <span style=""color:#F80000;"">W@[7, 9, 8]:0</span> + <span style=""color:#F80000;"">W@[7, 13, 1]:0</span> + <span style=""color:#F80000;"">W@[7, 13, 2]:0</span> + <span style=""color:#F80000;"">W@[7, 13, 3]:0</span> + <span style=""color:#F80000;"">W@[7, 13, 4]:0</span> + <span style=""color:#F80000;"">W@[7, 13, 5]:0</span> + <span style=""color:#F80000;"">BG@[7, 13, 6]:0</span> + <span style=""color:#F80000;"">W:BL@[7, 13, 7]:0</span> + <span style=""color:#F80000;"">W@[7, 13, 8]:0</span> + <span style=""color:#F80000;"">W@[7, 14, 1]:0</span> + <span style=""color:#F80000;"">W@[7, 14, 2]:0</span> + <span style=""color:#F80000;"">W@[7, 14, 3]:0</span> + <span style=""color:#F80000;"">W@[7, 14, 4]:0</span> + <span style=""color:#F80000;"">W@[7, 14, 5]:0</span> + <span style=""color:#F80000;"">BG@[7, 14, 6]:0</span> + <span style=""color:#F80000;"">W:BG@[7, 14, 7]:0</span> + <span style=""color:#F80000;"">W@[7, 14, 8]:0</span> + <span style=""color:#F80000;"">W@[7, 15, 1]:0</span> + <span style=""color:#F80000;"">W@[7, 15, 2]:0</span> + <span style=""color:#F80000;"">W@[7, 15, 3]:0</span> + <span style=""color:#F80000;"">W@[7, 15, 4]:0</span> + <span style=""color:#F80000;"">W@[7, 15, 5]:0</span> + <span style=""color:#F80000;"">BG@[7, 15, 6]:0</span> + <span style=""color:#F80000;"">W:BL@[7, 15, 7]:0</span> + <span style=""color:#F80000;"">W@[7, 15, 8]:0</span> + <span style=""color:#F80000;"">W@[7, 16, 1]:0</span> + <span style=""color:#F80000;"">W@[7, 16, 2]:0</span> + <span style=""color:#F80000;"">W@[7, 16, 3]:0</span> + <span style=""color:#F80000;"">W@[7, 16, 4]:0</span> + <span style=""color:#F80000;"">W@[7, 16, 5]:0</span> + <span style=""color:#F80000;"">BG@[7, 16, 6]:0</span> + <span style=""color:#F80000;"">W:BL@[7, 16, 7]:0</span> + <span style=""color:#F80000;"">W@[7, 16, 8]:0</span>",3,45
88,1000321,UR093,89,False,False,1012031,5,193,"W@[6, 1]:0 + W@[6, 2]:0 + MB@[6, 3]:0 + B@[6, 4]:4 + HB@[6, 5]:0 + B@[6, 6]:0 + W@[6, 7]:0 + AB:CB@[6, 8]:0 + GG-MB@[6, 9]:1 + AB-BG@[6, 10]:1 + W@[6, 11]:0 + W@[6, 12]:1 + W@[6, 13]:1 + GG@[6, 14]:1 + BG@[6, 15]:1 + GG@[6, 16]:1 + W@[6, 17]:1 + W:RB@[6, 18]:1 + W@[6, 19]:1 + AB@[6, 20]:10 + RB@[6, 21]:0 + MB@[6, 22]:0 + PR@[6, 23]:3 + W-MB@[6, 24]:3 + AB@[6, 25]:0 + AB@[6, 26]:0 + 0G@[6, 27]:10 + W@[6, 28]:1 + W@[6, 29]:0 + AB-RB@[6, 30]:1 + YB@[6, 31]:1 + YB@[6, 32]:0 + YB@[6, 33]:0 + W-AB@[6, 34]:0 + BL:AB@[6, 35]:1 + MB@[6, 36]:0 + AB@[6, 37]:0 + W@[6, 38]:2 + W@[6, 39]:1 + <span style=""color:#F80000;"">W@[6, 4, 1]:2</span> + <span style=""color:#F80000;"">W@[6, 4, 2]:0</span> + <span style=""color:#F80000;"">W@[6, 4, 3]:0</span> + <span style=""color:#F80000;"">W@[6, 4, 4]:0</span> + <span style=""color:#F80000;"">W@[6, 4, 5]:0</span> + <span style=""color:#F80000;"">LG@[6, 4, 6]:0</span> + <span style=""color:#F80000;"">W:GG@[6, 4, 7]:0</span> + <span style=""color:#F80000;"">W@[6, 4, 8]:0</span> + <span style=""color:#F80000;"">W@[6, 9, 1]:0</span> + <span style=""color:#F80000;"">W@[6, 9, 2]:0</span> + <span style=""color:#F80000;"">W@[6, 9, 3]:0</span> + <span style=""color:#F80000;"">W@[6, 9, 4]:0</span> + <span style=""color:#F80000;"">W@[6, 9, 5]:0</span> + <span style=""color:#F80000;"">GG@[6, 9, 6]:0</span> + <span style=""color:#F80000;"">W:PB@[6, 9, 7]:0</span> + <span style=""color:#F80000;"">W@[6, 9, 8]:0</span> + <span style=""color:#F80000;"">W@[6, 10, 1]:0</span> + <span style=""color:#F80000;"">W@[6, 10, 2]:0</span> + <span style=""color:#F80000;"">W@[6, 10, 3]:0</span> + <span style=""color:#F80000;"">W@[6, 10, 4]:0</span> + <span style=""color:#F80000;"">W@[6, 10, 5]:0</span> + <span style=""color:#F80000;"">BG@[6, 10, 6]:0</span> + <span style=""color:#F80000;"">W:LC@[6, 10, 7]:0</span> + <span style=""color:#F80000;"">W@[6, 10, 8]:0</span> + <span style=""color:#F80000;"">W@[6, 11, 1]:0</span> + <span style=""color:#F80000;"">W@[6, 11, 2]:0</span> + <span style=""color:#F80000;"">W@[6, 11, 3]:0</span> + <span style=""color:#F80000;"">W@[6, 11, 4]:0</span> + <span style=""color:#F80000;"">W@[6, 11, 5]:0</span> + <span style=""color:#F80000;"">TG@[6, 11, 6]:0</span> + <span style=""color:#F80000;"">W:TG@[6, 11, 7]:0</span> + <span style=""color:#F80000;"">W@[6, 11, 8]:0</span> + <span style=""color:#F80000;"">W@[6, 12, 1]:0</span> + <span style=""color:#F80000;"">W@[6, 12, 2]:0</span> + <span style=""color:#F80000;"">W@[6, 12, 3]:0</span> + <span style=""color:#F80000;"">W@[6, 12, 4]:0</span> + <span style=""color:#F80000;"">W@[6, 12, 5]:0</span> + <span style=""color:#F80000;"">BG@[6, 12, 6]:0</span> + <span style=""color:#F80000;"">W:LC@[6, 12, 7]:0</span> + <span style=""color:#F80000;"">W@[6, 12, 8]:0</span> + <span style=""color:#F80000;"">W@[6, 14, 1]:0</span> + <span style=""color:#F80000;"">W@[6, 14, 2]:0</span> + <span style=""color:#F80000;"">W@[6, 14, 3]:0</span> + <span style=""color:#F80000;"">W@[6, 14, 4]:0</span> + <span style=""color:#F80000;"">W@[6, 14, 5]:0</span> + <span style=""color:#F80000;"">LG@[6, 14, 6]:0</span> + <span style=""color:#F80000;"">W:TG@[6, 14, 7]:0</span> + <span style=""color:#F80000;"">W@[6, 14, 8]:0</span> + <span style=""color:#F80000;"">W@[6, 17, 1]:0</span> + <span style=""color:#F80000;"">W@[6, 17, 2]:0</span> + <span style=""color:#F80000;"">W@[6, 17, 3]:0</span> + <span style=""color:#F80000;"">W@[6, 17, 4]:0</span> + <span style=""color:#F80000;"">W@[6, 17, 5]:0</span> + <span style=""color:#F80000;"">TG@[6, 17, 6]:0</span> + <span style=""color:#F80000;"">W:BG@[6, 17, 7]:0</span> + <span style=""color:#F80000;"">W@[6, 17, 8]:0</span> + <span style=""color:#F80000;"">W@[6, 18, 1]:0</span> + <span style=""color:#F80000;"">W@[6, 18, 2]:0</span> + <span style=""color:#F80000;"">W@[6, 18, 3]:0</span> + <span style=""color:#F80000;"">W@[6, 18, 4]:0</span> + <span style=""color:#F80000;"">W@[6, 18, 5]:0</span> + <span style=""color:#F80000;"">BL@[6, 18, 6]:0</span> + <span style=""color:#F80000;"">W:GG@[6, 18, 7]:0</span> + <span style=""color:#F80000;"">W@[6, 18, 8]:0</span> + <span style=""color:#F80000;"">W@[6, 23, 1]:1</span> + <span style=""color:#F80000;"">W@[6, 23, 2]:0</span> + <span style=""color:#F80000;"">W@[6, 23, 3]:1</span> + <span style=""color:#F80000;"">W@[6, 23, 4]:1</span> + <span style=""color:#F80000;"">W@[6, 23, 5]:1</span> + <span style=""color:#F80000;"">PB@[6, 23, 6]:0</span> + <span style=""color:#F80000;"">W:BG@[6, 23, 7]:0</span> + <span style=""color:#F80000;"">W@[6, 23, 8]:0</span> + <span style=""color:#F80000;"">W@[6, 24, 1]:0</span> + <span style=""color:#F80000;"">W@[6, 24, 2]:0</span> + <span style=""color:#F80000;"">W@[6, 24, 3]:0</span> + <span style=""color:#F80000;"">W@[6, 24, 4]:1</span> + <span style=""color:#F80000;"">W@[6, 24, 5]:0</span> + <span style=""color:#F80000;"">VB@[6, 24, 6]:0</span> + <span style=""color:#F80000;"">W:BG@[6, 24, 7]:0</span> + <span style=""color:#F80000;"">W@[6, 24, 8]:0</span> + <span style=""color:#F80000;"">W@[6, 27, 1]:0</span> + <span style=""color:#F80000;"">W@[6, 27, 2]:0</span> + <span style=""color:#F80000;"">W@[6, 27, 3]:1</span> + <span style=""color:#F80000;"">W@[6, 27, 4]:3</span> + <span style=""color:#F80000;"">W@[6, 27, 5]:4</span> + <span style=""color:#F80000;"">VB@[6, 27, 6]:4</span> + <span style=""color:#F80000;"">W:GG@[6, 27, 7]:3</span> + <span style=""color:#F80000;"">W@[6, 27, 8]:1</span> + <span style=""color:#F80000;"">W@[6, 28, 1]:0</span> + <span style=""color:#F80000;"">W@[6, 28, 2]:0</span> + <span style=""color:#F80000;"">W@[6, 28, 3]:0</span> + <span style=""color:#F80000;"">W@[6, 28, 4]:0</span> + <span style=""color:#F80000;"">W@[6, 28, 5]:0</span> + <span style=""color:#F80000;"">VB@[6, 28, 6]:0</span> + <span style=""color:#F80000;"">W:0D@[6, 28, 7]:0</span> + <span style=""color:#F80000;"">W@[6, 28, 8]:0</span> + <span style=""color:#F80000;"">W@[6, 30, 1]:0</span> + <span style=""color:#F80000;"">W@[6, 30, 2]:0</span> + <span style=""color:#F80000;"">W@[6, 30, 3]:0</span> + <span style=""color:#F80000;"">W@[6, 30, 4]:0</span> + <span style=""color:#F80000;"">W@[6, 30, 5]:0</span> + <span style=""color:#F80000;"">LG@[6, 30, 6]:0</span> + <span style=""color:#F80000;"">W:BG@[6, 30, 7]:0</span> + <span style=""color:#F80000;"">W@[6, 30, 8]:0</span> + <span style=""color:#F80000;"">W@[6, 31, 1]:0</span> + <span style=""color:#F80000;"">W@[6, 31, 2]:0</span> + <span style=""color:#F80000;"">W@[6, 31, 3]:0</span> + <span style=""color:#F80000;"">W@[6, 31, 4]:0</span> + <span style=""color:#F80000;"">W@[6, 31, 5]:0</span> + <span style=""color:#F80000;"">AB:BG@[6, 31, 6]:0</span> + <span style=""color:#F80000;"">W:LC@[6, 31, 7]:0</span> + <span style=""color:#F80000;"">W@[6, 31, 8]:0</span> + <span style=""color:#F80000;"">W-MB@[6, 32, 1]:7</span> + <span style=""color:#F80000;"">W@[6, 32, 1, 1]:1</span> + <span style=""color:#F80000;"">W@[6, 32, 1, 2]:1</span> + <span style=""color:#F80000;"">W@[6, 32, 1, 3]:0</span> + <span style=""color:#F80000;"">W@[6, 32, 1, 4]:3</span> + <span style=""color:#F80000;"">W@[6, 32, 1, 5]:3</span> + <span style=""color:#F80000;"">VB@[6, 32, 1, 6]:0</span> + <span style=""color:#F80000;"">W:VB@[6, 32, 1, 7]:0</span> + <span style=""color:#F80000;"">W@[6, 32, 1, 8]:0</span> + <span style=""color:#F80000;"">W@[6, 33, 1]:0</span> + <span style=""color:#F80000;"">W@[6, 33, 2]:0</span> + <span style=""color:#F80000;"">W@[6, 33, 3]:0</span> + <span style=""color:#F80000;"">W@[6, 33, 4]:0</span> + <span style=""color:#F80000;"">W@[6, 33, 5]:0</span> + <span style=""color:#F80000;"">VB@[6, 33, 6]:0</span> + <span style=""color:#F80000;"">W:LD@[6, 33, 7]:1</span> + <span style=""color:#F80000;"">W@[6, 33, 8]:0</span> + <span style=""color:#F80000;"">W@[6, 33, 9]:0</span> + <span style=""color:#F80000;"">YB@[6, 34, 1]:0</span> + <span style=""color:#F80000;"">W@[6, 34, 2]:1</span> + <span style=""color:#F80000;"">W@[6, 34, 3]:0</span> + <span style=""color:#F80000;"">W@[6, 34, 4]:0</span> + <span style=""color:#F80000;"">W@[6, 34, 5]:0</span> + <span style=""color:#F80000;"">VB@[6, 34, 6]:0</span> + <span style=""color:#F80000;"">W:VB@[6, 34, 7]:0</span> + <span style=""color:#F80000;"">AB@[6, 34, 8]:0</span> + <span style=""color:#F80000;"">W@[6, 38, 1]:0</span> + <span style=""color:#F80000;"">W@[6, 38, 2]:0</span> + <span style=""color:#F80000;"">W@[6, 38, 3]:0</span> + <span style=""color:#F80000;"">W@[6, 38, 4]:1</span> + <span style=""color:#F80000;"">W@[6, 38, 5]:0</span> + <span style=""color:#F80000;"">BG@[6, 38, 6]:0</span> + <span style=""color:#F80000;"">W:BG@[6, 38, 7]:0</span> + <span style=""color:#F80000;"">W@[6, 38, 8]:0</span> + <span style=""color:#F80000;"">W@[6, 39, 1]:1</span> + <span style=""color:#F80000;"">W@[6, 39, 2]:0</span> + <span style=""color:#F80000;"">W@[6, 39, 3]:0</span> + <span style=""color:#F80000;"">W@[6, 39, 4]:0</span> + <span style=""color:#F80000;"">W@[6, 39, 5]:0</span> + <span style=""color:#F80000;"">BG@[6, 39, 6]:0</span> + <span style=""color:#F80000;"">W:GG@[6, 39, 7]:0</span> + <span style=""color:#F80000;"">W@[6, 39, 8]:0</span>",1012035,9,130,"PR@[10, 1]:7 + W:AB@[10, 2]:6 + RB@[10, 3]:2 + AB:GG:MB@[10, 4]:0 + 0L@[10, 5]:15 + W@[10, 6]:1 + AB-MB@[10, 7]:2 + AB@[10, 8]:1 + RL:PB@[10, 9]:1 + HB@[10, 10]:0 + GG@[10, 11]:1 + RL@[10, 12]:1 + AB@[10, 13]:1 + W@[10, 14]:7 + W@[10, 15]:2 + W@[10, 16]:2 + <span style=""color:#F80000;"">W@[10, 1, 1]:1</span> + <span style=""color:#F80000;"">W@[10, 1, 2]:1</span> + <span style=""color:#F80000;"">W@[10, 1, 3]:1</span> + <span style=""color:#F80000;"">W@[10, 1, 4]:0</span> + <span style=""color:#F80000;"">W@[10, 1, 5]:0</span> + <span style=""color:#F80000;"">GG@[10, 1, 6]:0</span> + <span style=""color:#F80000;"">W:GG@[10, 1, 7]:2</span> + <span style=""color:#F80000;"">W@[10, 1, 8]:0</span> + <span style=""color:#F80000;"">W@[10, 2, 1]:0</span> + <span style=""color:#F80000;"">W@[10, 2, 2]:0</span> + <span style=""color:#F80000;"">W@[10, 2, 3]:0</span> + <span style=""color:#F80000;"">W@[10, 2, 4]:2</span> + <span style=""color:#F80000;"">W@[10, 2, 5]:1</span> + <span style=""color:#F80000;"">BG@[10, 2, 6]:0</span> + <span style=""color:#F80000;"">W:BG@[10, 2, 7]:0</span> + <span style=""color:#F80000;"">W@[10, 2, 8]:0</span> + <span style=""color:#F80000;"">W@[10, 3, 1]:0</span> + <span style=""color:#F80000;"">W@[10, 3, 2]:1</span> + <span style=""color:#F80000;"">W@[10, 3, 3]:0</span> + <span style=""color:#F80000;"">W@[10, 3, 4]:0</span> + <span style=""color:#F80000;"">W@[10, 3, 5]:0</span> + <span style=""color:#F80000;"">BG@[10, 3, 6]:0</span> + <span style=""color:#F80000;"">W:BG@[10, 3, 7]:0</span> + <span style=""color:#F80000;"">W@[10, 3, 8]:0</span> + <span style=""color:#F80000;"">W@[10, 4, 1]:0</span> + <span style=""color:#F80000;"">W@[10, 4, 2]:0</span> + <span style=""color:#F80000;"">W@[10, 4, 3]:0</span> + <span style=""color:#F80000;"">W@[10, 4, 4]:0</span> + <span style=""color:#F80000;"">W@[10, 4, 5]:0</span> + <span style=""color:#F80000;"">BG@[10, 4, 6]:0</span> + <span style=""color:#F80000;"">W:BG@[10, 4, 7]:0</span> + <span style=""color:#F80000;"">W@[10, 4, 8]:0</span> + <span style=""color:#F80000;"">W@[10, 4, 9]:0</span> + <span style=""color:#F80000;"">W@[10, 5, 1]:1</span> + <span style=""color:#F80000;"">W@[10, 5, 2]:0</span> + <span style=""color:#F80000;"">W@[10, 5, 3]:1</span> + <span style=""color:#F80000;"">W@[10, 5, 4]:5</span> + <span style=""color:#F80000;"">W@[10, 5, 5]:1</span> + <span style=""color:#F80000;"">GG@[10, 5, 6]:2</span> + <span style=""color:#F80000;"">W:GG@[10, 5, 7]:4</span> + <span style=""color:#F80000;"">W@[10, 5, 8]:0</span> + <span style=""color:#F80000;"">W@[10, 6, 1]:1</span> + <span style=""color:#F80000;"">W@[10, 6, 2]:0</span> + <span style=""color:#F80000;"">W@[10, 6, 3]:0</span> + <span style=""color:#F80000;"">W@[10, 6, 4]:0</span> + <span style=""color:#F80000;"">W@[10, 6, 5]:0</span> + <span style=""color:#F80000;"">BG@[10, 6, 6]:0</span> + <span style=""color:#F80000;"">W:BG@[10, 6, 7]:0</span> + <span style=""color:#F80000;"">W@[10, 6, 8]:0</span> + <span style=""color:#F80000;"">W@[10, 7, 1]:0</span> + <span style=""color:#F80000;"">W@[10, 7, 2]:0</span> + <span style=""color:#F80000;"">W@[10, 7, 3]:1</span> + <span style=""color:#F80000;"">W@[10, 7, 4]:1</span> + <span style=""color:#F80000;"">W@[10, 7, 5]:0</span> + <span style=""color:#F80000;"">BG@[10, 7, 6]:0</span> + <span style=""color:#F80000;"">W:BG@[10, 7, 7]:2</span> + <span style=""color:#F80000;"">W@[10, 7, 8]:1</span> + <span style=""color:#F80000;"">W-RB@[10, 9, 1]:4</span> + <span style=""color:#F80000;"">W@[10, 9, 1, 1]:1</span> + <span style=""color:#F80000;"">W@[10, 9, 1, 2]:0</span> + <span style=""color:#F80000;"">W@[10, 9, 1, 3]:2</span> + <span style=""color:#F80000;"">W@[10, 9, 1, 4]:0</span> + <span style=""color:#F80000;"">W@[10, 9, 1, 5]:0</span> + <span style=""color:#F80000;"">GG@[10, 9, 1, 6]:0</span> + <span style=""color:#F80000;"">BG@[10, 9, 1, 7]:0</span> + <span style=""color:#F80000;"">W@[10, 9, 1, 8]:0</span> + <span style=""color:#F80000;"">W@[10, 9, 10]:1</span> + <span style=""color:#F80000;"">W@[10, 9, 11]:1</span> + <span style=""color:#F80000;"">W@[10, 9, 12]:0</span> + <span style=""color:#F80000;"">W@[10, 9, 13]:0</span> + <span style=""color:#F80000;"">W@[10, 9, 14]:0</span> + <span style=""color:#F80000;"">BG@[10, 9, 15]:0</span> + <span style=""color:#F80000;"">W:BG@[10, 9, 16]:0</span> + <span style=""color:#F80000;"">W@[10, 9, 17]:0</span> + <span style=""color:#F80000;"">W@[10, 10, 1]:0</span> + <span style=""color:#F80000;"">W@[10, 10, 2]:0</span> + <span style=""color:#F80000;"">W@[10, 10, 3]:0</span> + <span style=""color:#F80000;"">W@[10, 10, 4]:0</span> + <span style=""color:#F80000;"">W@[10, 10, 5]:0</span> + <span style=""color:#F80000;"">BG@[10, 10, 6]:0</span> + <span style=""color:#F80000;"">W:BG@[10, 10, 7]:0</span> + <span style=""color:#F80000;"">W@[10, 10, 8]:0</span> + <span style=""color:#F80000;"">W@[10, 11, 1]:0</span> + <span style=""color:#F80000;"">W@[10, 11, 2]:0</span> + <span style=""color:#F80000;"">W@[10, 11, 3]:0</span> + <span style=""color:#F80000;"">W@[10, 11, 4]:0</span> + <span style=""color:#F80000;"">W@[10, 11, 5]:0</span> + <span style=""color:#F80000;"">GG@[10, 11, 6]:0</span> + <span style=""color:#F80000;"">W:GG@[10, 11, 7]:0</span> + <span style=""color:#F80000;"">W@[10, 11, 8]:0</span> + <span style=""color:#F80000;"">W@[10, 14, 1]:0</span> + <span style=""color:#F80000;"">W@[10, 14, 2]:0</span> + <span style=""color:#F80000;"">W@[10, 14, 3]:0</span> + <span style=""color:#F80000;"">W@[10, 14, 4]:2</span> + <span style=""color:#F80000;"">W@[10, 14, 5]:0</span> + <span style=""color:#F80000;"">BG@[10, 14, 6]:0</span> + <span style=""color:#F80000;"">W:BG@[10, 14, 7]:0</span> + <span style=""color:#F80000;"">W@[10, 14, 8]:0</span> + <span style=""color:#F80000;"">W@[10, 15, 1]:0</span> + <span style=""color:#F80000;"">W@[10, 15, 2]:0</span> + <span style=""color:#F80000;"">W@[10, 15, 3]:0</span> + <span style=""color:#F80000;"">W@[10, 15, 4]:0</span> + <span style=""color:#F80000;"">W@[10, 15, 5]:0</span> + <span style=""color:#F80000;"">VB@[10, 15, 6]:0</span> + <span style=""color:#F80000;"">W:VB@[10, 15, 7]:0</span> + <span style=""color:#F80000;"">W@[10, 15, 8]:0</span> + <span style=""color:#F80000;"">W@[10, 16, 1]:0</span> + <span style=""color:#F80000;"">W@[10, 16, 2]:0</span> + <span style=""color:#F80000;"">W@[10, 16, 3]:0</span> + <span style=""color:#F80000;"">W@[10, 16, 4]:0</span> + <span style=""color:#F80000;"">W@[10, 16, 5]:0</span> + <span style=""color:#F80000;"">BG@[10, 16, 6]:0</span> + <span style=""color:#F80000;"">W:BG@[10, 16, 7]:0</span> + <span style=""color:#F80000;"">W@[10, 16, 8]:0</span>",4,63
89,1000344,UR1084,1493,False,False,1012915,1,12,"W@[2, 1]:1091 + W@[2, 2]:0 + W@[2, 3]:22 + MB@[2, 4]:100 + BY:BL@[2, 5]:40 + W-BY@[2, 6]:23 + W-BY@[2, 7]:33 + W:BL@[2, 8]:76 + W:BY@[2, 9]:33 + W:MB@[2, 10]:33 + W@[2, 11]:42 + @[2, 12]:0",1012935,21,14,"W@[22, 1]:1162 + W-BY@[22, 2]:13 + BY:MB@[22, 3]:45 + W@[22, 4]:100 + W:BY@[22, 5]:6 + W:MB@[22, 6]:12 + W:BL@[22, 7]:23 + W@[22, 8]:23 + W:MB@[22, 9]:23 + W:BY@[22, 10]:23 + MB@[22, 11]:0 + W@[22, 12]:32 + MB@[22, 13]:0 + MB@[22, 14]:31",20,2
90,1000344,UR1084,1688,False,False,1012919,5,12,"W@[6, 1]:1078 + W@[6, 2]:12 + MB@[6, 3]:100 + W:BL:MB@[6, 4]:50 + W-MB@[6, 5]:220 + W-BY@[6, 6]:22 + W-BY@[6, 7]:33 + BY:BL@[6, 8]:66 + W:BY@[6, 9]:32 + W:MB@[6, 10]:33 + W@[6, 11]:42 + @[6, 12]:0",1012923,9,11,"W@[10, 1]:1087 + W@[10, 2]:12 + MB@[10, 3]:100 + W:BL:MB@[10, 4]:40 + W-MB@[10, 5]:222 + W-BY@[10, 6]:22 + W-BY@[10, 7]:32 + W:BL@[10, 8]:76 + W:BY@[10, 9]:22 + W:MB@[10, 10]:33 + W@[10, 11]:42",4,1
91,1000315,UR1096,45,True,False,1008703,12,6,"W@[13, 1]:5 + W@[13, 2]:3 + W@[13, 3]:29 + W@[13, 4]:4 + W@[13, 5]:0 + W@[13, 6]:4",1008704,13,1,"W@[14, 1]:45",1,5
92,1000042,UR1100,624,False,False,1001881,0,2,"W@[1, 1]:259 + <span style=""color:#F80000;"">G0@[1, 1, 1]:365</span>",1001882,1,12,"W@[2, 1]:81 + W@[2, 2]:38 + B@[2, 3]:31 + W@[2, 4]:42 + DB@[2, 5]:31 + B@[2, 6]:36 + <span style=""color:#F80000;"">DB@[2, 1, 1]:54</span> + <span style=""color:#F80000;"">DB@[2, 2, 1]:60</span> + <span style=""color:#F80000;"">DB@[2, 3, 1]:61</span> + <span style=""color:#F80000;"">DB@[2, 4, 1]:60</span> + <span style=""color:#F80000;"">DB@[2, 5, 1]:70</span> + <span style=""color:#F80000;"">DB@[2, 6, 1]:60</span>",1,10
93,1000053,UR1109,682,False,True,1002104,1,5,"YG@[2, 1]:100 + DB@[2, 2]:213 + DB-CB@[2, 3]:125 + YG-DB@[2, 4]:104 + YG@[2, 5]:140",1002105,2,5,"YG@[3, 1]:100 + DB@[3, 2]:213 + DB-CB@[3, 3]:125 + YG-DB@[3, 4]:104 + YG@[3, 5]:140",1,0
94,1000053,UR1109,477,False,False,1002108,5,5,"YG@[6, 1]:80 + DB@[6, 2]:152 + DB-CB@[6, 3]:125 + YG-DB@[6, 4]:0 + YG@[6, 5]:120",1002109,6,5,"YG@[7, 1]:80 + DB@[7, 2]:152 + DB-CB@[7, 3]:125 + DB-CB@[7, 4]:0 + YG@[7, 5]:120",1,0
95,1000053,UR1109,545,False,True,1002115,12,5,"YG@[13, 1]:100 + DB@[13, 2]:200 + DB-CB@[13, 3]:120 + YG:DB@[13, 4]:0 + YG@[13, 5]:125",1002118,15,5,"YG@[16, 1]:100 + DB@[16, 2]:200 + DB-CB@[16, 3]:120 + YG:DB@[16, 4]:0 + YG@[16, 5]:125",3,0
96,1000053,UR1109,555,False,False,1002116,13,5,"YG@[14, 1]:100 + DB@[14, 2]:200 + DB-CB@[14, 3]:130 + YG:DB@[14, 4]:0 + YG@[14, 5]:125",1002117,14,5,"YG@[15, 1]:100 + DB@[15, 2]:0 + DB-CB@[15, 3]:0 + YG:DB@[15, 4]:330 + YG@[15, 5]:125",1,0
97,1000053,UR1109,570,False,True,1002125,22,5,"YG:DB@[23, 1]:90 + W:DB@[23, 2]:200 + W:DB@[23, 3]:120 + YG-DB@[23, 4]:40 + YG@[23, 5]:120",1002126,23,5,"YG:DB@[24, 1]:90 + W:DB@[24, 2]:200 + W:DB@[24, 3]:120 + YG-DB@[24, 4]:40 + YG@[24, 5]:120",1,0
98,1000053,UR1109,600,False,False,1002136,33,5,"YG@[34, 1]:100 + DB@[34, 2]:200 + DB-CB@[34, 3]:200 + YG-DB@[34, 4]:0 + YG@[34, 5]:100",1002138,35,5,"YG@[36, 1]:100 + DB@[36, 2]:200 + DB-CB@[36, 3]:100 + YG-DB@[36, 4]:100 + YG@[36, 5]:100",2,0
99,1000053,UR1109,240,False,False,1002149,46,2,"DB-CB@[47, 1]:140 + DB@[47, 2]:100",1002152,49,2,"DB-CB@[50, 1]:130 + DB@[50, 2]:110",3,0
100,1000053,UR1109,520,False,False,1002157,54,4,"YG@[55, 1]:70 + DB@[55, 2]:200 + DB-CB@[55, 3]:100 + YG@[55, 4]:150",1002159,56,4,"YG@[57, 1]:70 + DB@[57, 2]:100 + DB-CB@[57, 3]:200 + YG@[57, 4]:150",2,0
101,1000053,UR1109,202,False,True,1002162,59,3,"DB@[60, 1]:202 + DB-CB@[60, 2]:0 + YG-DB@[60, 3]:0",1002163,60,3,"DB@[61, 1]:202 + DB-CB@[61, 2]:0 + YG-DB@[61, 3]:0",1,0
102,1000053,UR1109,202,False,False,1002164,61,3,"DB@[62, 1]:202 + YG-DB@[62, 2]:0 + YG-DB@[62, 3]:0",1002165,62,3,"YG-DB@[63, 1]:0 + YG-DB@[63, 2]:202 + DB-CB@[63, 3]:0",1,0
103,1000053,UR1109,202,False,True,1002166,63,3,"DB@[64, 1]:202 + DB-CB@[64, 2]:0 + YG-DB@[64, 3]:0",1002167,64,3,"DB@[65, 1]:202 + DB-CB@[65, 2]:0 + YG-DB@[65, 3]:0",1,0
104,1000083,UR1126,170,False,False,1002505,2,10,"W-DB@[3, 1]:21 + W-DB@[3, 2]:20 + W-DB@[3, 3]:21 + W-DB@[3, 4]:12 + W-DB@[3, 5]:20 + W-DB@[3, 6]:12 + W-DB@[3, 7]:20 + W-DB@[3, 8]:12 + W-DB@[3, 9]:20 + W-DB@[3, 10]:12",1002509,6,10,"W-CB@[7, 1]:21 + W-CB@[7, 2]:20 + W-CB@[7, 3]:21 + W-CB@[7, 4]:12 + W-CB@[7, 5]:20 + W-CB@[7, 6]:12 + W-CB@[7, 7]:20 + W-CB@[7, 8]:12 + W-CB@[7, 9]:20 + W-CB@[7, 10]:12",4,0
105,1000083,UR1126,150,False,False,1002507,4,10,"W-CB@[5, 1]:21 + W-CB@[5, 2]:20 + GG@[5, 3]:21 + W-CB@[5, 4]:12 + W-CB@[5, 5]:20 + W-CB@[5, 6]:12 + @[5, 7]:0 + W-CB@[5, 8]:12 + W-CB@[5, 9]:20 + W-CB@[5, 10]:12",1002511,8,10,"CB@[9, 1]:20 + CB@[9, 2]:20 + CB@[9, 3]:20 + CB@[9, 4]:12 + CB@[9, 5]:12 + CB@[9, 6]:20 + CB@[9, 7]:12 + CB@[9, 8]:12 + CB@[9, 9]:11 + CB@[9, 10]:11",4,0
106,1000084,UR1127,175,False,False,1002569,0,1,"W@[1, 1]:175",1002570,1,5,"DB@[2, 1]:33 + DB@[2, 2]:12 + DB@[2, 3]:45 + DB@[2, 4]:85 + DB@[2, 5]:0",1,4
107,1000292,UR113,38,False,False,1007741,15,7,"W:RB@[16, 1]:10 + W:RB@[16, 2]:7 + W:RB@[16, 3]:4 + W:RB@[16, 4]:10 + W:RB@[16, 5]:4 + <span style=""color:#F80000;"">KB@[16, 3, 1]:0</span> + <span style=""color:#F80000;"">KB@[16, 4, 1]:3</span>",1007755,29,6,"G0@[30, 1]:4 + G0@[30, 2]:6 + G0@[30, 3]:5 + G0@[30, 4]:11 + G0@[30, 5]:6 + G0@[30, 6]:6",14,1
108,1000087,UR1130,63,False,False,1002616,0,2,"W@[1, 1]:37 + <span style=""color:#F80000;"">W:DB@[1, 1, 1]:26</span>",1002617,1,26,"W:YB@[2, 1]:1 + W@[2, 2]:1 + YB@[2, 3]:2 + DB@[2, 4]:3 + BS@[2, 5]:0 + LB@[2, 6]:0 + LB:YG@[2, 7]:1 + W-DB@[2, 8]:1 + YB:BS@[2, 9]:3 + BS:LB:YG@[2, 10]:2 + W:DB@[2, 11]:1 + YB@[2, 12]:4 + W:DB@[2, 13]:4 + W:DB@[2, 14]:6 + W:DB@[2, 15]:5 + <span style=""color:#F80000;"">YB@[2, 1, 1]:1</span> + <span style=""color:#F80000;"">YB@[2, 2, 1]:2</span> + <span style=""color:#F80000;"">W:DB@[2, 3, 1]:2</span> + <span style=""color:#F80000;"">YB@[2, 4, 1]:1</span> + <span style=""color:#F80000;"">YB@[2, 9, 1]:3</span> + <span style=""color:#F80000;"">YB@[2, 10, 1]:1</span> + <span style=""color:#F80000;"">YB@[2, 11, 1]:1</span> + <span style=""color:#F80000;"">YB@[2, 12, 1]:3</span> + <span style=""color:#F80000;"">YB@[2, 13, 1]:4</span> + <span style=""color:#F80000;"">YB@[2, 14, 1]:6</span> + <span style=""color:#F80000;"">YB@[2, 15, 1]:5</span>",1,24
109,1000094,UR1136,227,False,False,1002850,6,16,"B@[7, 1]:25 + B@[7, 2]:31 + B@[7, 3]:22 + B@[7, 4]:14 + B@[7, 5]:21 + B@[7, 6]:18 + B@[7, 7]:16 + B@[7, 8]:6 + B@[7, 9]:62 + <span style=""color:#F80000;"">BB@[7, 2, 1]:1</span> + <span style=""color:#F80000;"">B@[7, 2, 2]:3</span> + <span style=""color:#F80000;"">BB@[7, 4, 1]:1</span> + <span style=""color:#F80000;"">BB@[7, 5, 1]:0</span> + <span style=""color:#F80000;"">BB@[7, 7, 1]:1</span> + <span style=""color:#F80000;"">BB@[7, 9, 1]:3</span> + <span style=""color:#F80000;"">B@[7, 9, 2]:3</span>",1002841,15,11,"W@[16, 1]:100 + W@[16, 2]:5 + W:BB@[16, 3]:16 + W:BB@[16, 4]:19 + W@[16, 5]:19 + W@[16, 6]:20 + W@[16, 7]:27 + W@[16, 8]:11 + W@[16, 9]:6 + <span style=""color:#F80000;"">B@[16, 1, 1]:3</span> + <span style=""color:#F80000;"">B@[16, 9, 1]:1</span>",9,5
110,1000287,UR114,31,False,False,1007647,3,15,"W-AB@[4, 1]:0 + W@[4, 2]:0 + W@[4, 3]:1 + MB@[4, 4]:4 + W:KB@[4, 5]:8 + W@[4, 6]:0 + AB@[4, 7]:1 + BG@[4, 8]:1 + MB:KB@[4, 9]:0 + HB@[4, 10]:0 + <span style=""color:#F80000;"">HB@[4, 3, 1]:4</span> + <span style=""color:#F80000;"">HB@[4, 4, 1]:4</span> + <span style=""color:#F80000;"">HB@[4, 7, 1]:2</span> + <span style=""color:#F80000;"">MB@[4, 8, 1]:2</span> + <span style=""color:#F80000;"">AB@[4, 10, 1]:4</span>",1007651,7,18,"W:AB@[8, 1]:0 + W@[8, 2]:0 + W@[8, 3]:0 + W@[8, 4]:0 + W:AB@[8, 5]:0 + MB:KB@[8, 6]:0 + W:AB:KB@[8, 7]:0 + W:AB@[8, 8]:0 + W@[8, 9]:0 + W@[8, 10]:0 + MB-HB@[8, 11]:2 + YB@[8, 12]:0 + KB@[8, 13]:0 + YB@[8, 14]:4 + YB@[8, 15]:0 + GG:MB:HB@[8, 16]:0 + W@[8, 17]:6 + PK@[8, 18]:19",4,3
111,1000116,UR1141,44,False,True,1004261,2,2,"W@[3, 1]:22 + W@[3, 2]:22",1004263,4,2,"W@[5, 1]:22 + W@[5, 2]:22",2,0
112,1000116,UR1141,44,False,True,1004264,5,2,"W@[6, 1]:22 + W@[6, 2]:22",1004265,6,2,"W@[7, 1]:22 + W@[7, 2]:22",1,0
113,1000116,UR1141,44,False,True,1004266,7,2,"W@[8, 1]:22 + W@[8, 2]:22",1004267,8,2,"W@[9, 1]:22 + W@[9, 2]:22",1,0
114,1000124,UR1149,6330,False,True,1004354,3,4,"B:GG@[4, 1]:1430 + B:GG:LB@[4, 2]:670 + B@[4, 3]:3410 + GG@[4, 4]:820",1004355,4,4,"B:GG@[5, 1]:1430 + B:GG:LB@[5, 2]:670 + B@[5, 3]:3410 + GG@[5, 4]:820",1,0
115,1000124,UR1149,6330,False,True,1004356,5,4,"B:GG@[6, 1]:1430 + B:GG:LB@[6, 2]:670 + B@[6, 3]:3410 + GG@[6, 4]:820",1004357,6,4,"B:GG@[7, 1]:1430 + B:GG:LB@[7, 2]:670 + B@[7, 3]:3410 + GG@[7, 4]:820",1,0
116,1000137,UR1163,105,False,False,1004552,0,1,"B@[1, 1]:105",1004554,2,12,"B@[3, 1]:18 + BB@[3, 2]:21 + B@[3, 3]:18 + BB@[3, 4]:12 + B@[3, 5]:9 + BB@[3, 6]:9 + B@[3, 7]:5 + BB@[3, 8]:4 + BB@[3, 9]:3 + BB@[3, 10]:2 + B@[3, 11]:2 + BB@[3, 12]:2",2,11
117,1000139,UR1165,46,False,False,1004573,2,3,"B@[3, 1]:0 + W@[3, 2]:25 + DB@[3, 3]:21",1004574,3,3,"B@[4, 1]:0 + W@[4, 2]:14 + DB@[4, 3]:32",1,0
118,1000147,UR1175,171,False,False,1004816,17,7,"W@[18, 1]:3 + LB@[18, 2]:10 + YG@[18, 3]:120 + YB@[18, 4]:0 + YB:0G@[18, 5]:13 + <span style=""color:#F80000;"">W@[18, 1, 1]:0</span> + <span style=""color:#F80000;"">LB@[18, 2, 1]:25</span>",1004835,36,7,"W@[37, 1]:10 + LB@[37, 2]:12 + YG@[37, 3]:29 + YB@[37, 4]:50 + YB:0G@[37, 5]:60 + <span style=""color:#F80000;"">W@[37, 1, 1]:0</span> + <span style=""color:#F80000;"">LB@[37, 2, 1]:10</span>",19,0
119,1000148,UR1176,161,False,False,1004957,6,14,"RB@[7, 1]:0 + DB@[7, 2]:60 + DB@[7, 3]:17 + DB@[7, 4]:25 + DB@[7, 5]:21 + DB@[7, 6]:12 + DB@[7, 7]:0 + RB@[7, 8]:17 + <span style=""color:#F80000;"">DB@[7, 2, 1]:3</span> + <span style=""color:#F80000;"">YG@[7, 2, 1, 1]:1</span> + <span style=""color:#F80000;"">B@[7, 2, 1, 2]:1</span> + <span style=""color:#F80000;"">DB@[7, 2, 4]:0</span> + <span style=""color:#F80000;"">B@[7, 3, 1]:0</span> + <span style=""color:#F80000;"">YG@[7, 3, 1, 1]:4</span>",1004968,17,14,"RB@[18, 1]:0 + B@[18, 2]:0 + DB@[18, 3]:0 + DB@[18, 4]:45 + DB@[18, 5]:0 + DB@[18, 6]:28 + DB@[18, 7]:35 + DB@[18, 8]:19 + DB@[18, 9]:11 + RB@[18, 10]:15 + <span style=""color:#F80000;"">B@[18, 4, 1]:1</span> + <span style=""color:#F80000;"">YG@[18, 4, 1, 1]:3</span> + <span style=""color:#F80000;"">B@[18, 6, 1]:1</span> + <span style=""color:#F80000;"">YG@[18, 6, 1, 1]:3</span>",11,0
120,1000293,UR118,497,True,False,1008002,30,1,"W@[31, 1]:497",1008015,43,18,"AB:MB@[44, 1]:16 + AB:MB@[44, 2]:66 + AB:MB@[44, 3]:35 + AB:MB@[44, 4]:212 + AB:MB@[44, 5]:30 + AB:MB@[44, 6]:43 + <span style=""color:#F80000;"">W@[44, 2, 1]:23</span> + <span style=""color:#F80000;"">MB@[44, 2, 2]:6</span> + <span style=""color:#F80000;"">HB@[44, 2, 3]:16</span> + <span style=""color:#F80000;"">AB@[44, 2, 4]:3</span> + <span style=""color:#F80000;"">W:KB@[44, 3, 1]:11</span> + <span style=""color:#F80000;"">MB:KB@[44, 3, 2]:0</span> + <span style=""color:#F80000;"">W:AB@[44, 3, 3]:5</span> + <span style=""color:#F80000;"">MB@[44, 4, 1]:7</span> + <span style=""color:#F80000;"">W@[44, 4, 1, 1]:7</span> + <span style=""color:#F80000;"">HB@[44, 4, 3]:16</span> + <span style=""color:#F80000;"">HB@[44, 4, 4]:1</span> + <span style=""color:#F80000;"">MB:KB@[44, 4, 5]:0</span>",13,17
121,1000293,UR118,530,True,False,1008008,36,1,"W:KB@[37, 1]:530",1008010,38,1,"GG:MB@[39, 1]:530",2,0
122,1000415,UR145,33,False,True,1014351,1,1,"W@[2, 1]:33",1014363,13,1,"W@[14, 1]:33",12,0
123,1000415,UR145,24,False,True,1014354,4,1,"MB@[5, 1]:24",1014366,16,1,"MB@[17, 1]:24",12,0
124,1000415,UR145,31,False,False,1014355,5,1,"MB@[6, 1]:31",1014360,10,2,"MB@[11, 1]:16 + <span style=""color:#F80000;"">RB@[11, 1, 1]:15</span>",5,1
125,1000418,UR146,180,False,False,1014412,1,3,"AB@[2, 1]:138 + KB@[2, 2]:10 + <span style=""color:#F80000;"">AB@[2, 1, 1]:32</span>",1014424,13,1,"AB@[14, 1]:180",12,2
126,1000405,UR150,152,False,False,1014102,0,13,"AB@[1, 1]:7 + AB@[1, 2]:25 + AB@[1, 3]:15 + AB@[1, 4]:29 + AB@[1, 5]:13 + MB:KB@[1, 6]:12 + W:AB@[1, 7]:13 + AB@[1, 8]:7 + AB@[1, 9]:15 + <span style=""color:#F80000;"">MB@[1, 9, 1]:4</span> + <span style=""color:#F80000;"">GG@[1, 9, 2]:3</span> + <span style=""color:#F80000;"">AB@[1, 9, 3]:5</span> + <span style=""color:#F80000;"">AB@[1, 9, 4]:4</span>",1014103,1,12,"AB@[2, 1]:46 + AB:KB@[2, 2]:10 + W:MB@[2, 3]:7 + GG@[2, 4]:8 + GG@[2, 5]:12 + GG@[2, 6]:16 + GG@[2, 7]:29 + GG@[2, 8]:15 + <span style=""color:#F80000;"">MB@[2, 1, 1]:2</span> + <span style=""color:#F80000;"">AB@[2, 1, 2]:2</span> + <span style=""color:#F80000;"">AB:KB@[2, 4, 1]:2</span> + <span style=""color:#F80000;"">AB:KB@[2, 6, 1]:3</span>",1,1
127,1000397,UR160,147,False,False,1013942,0,14,"AB@[1, 1]:16 + AB@[1, 2]:7 + AB:KB@[1, 3]:17 + AB:KB@[1, 4]:5 + AB@[1, 5]:13 + AB@[1, 6]:30 + AB@[1, 7]:14 + AB@[1, 8]:23 + AB@[1, 9]:7 + <span style=""color:#F80000;"">MB@[1, 1, 1]:12</span> + <span style=""color:#F80000;"">MB@[1, 3, 1]:0</span> + <span style=""color:#F80000;"">AB@[1, 4, 1]:0</span> + <span style=""color:#F80000;"">MB@[1, 6, 1]:0</span> + <span style=""color:#F80000;"">KB@[1, 7, 1]:3</span>",1013943,1,11,"HB@[2, 1]:44 + HB@[2, 2]:17 + AB:KB@[2, 3]:7 + AB:MB@[2, 4]:5 + HB@[2, 5]:7 + HB@[2, 6]:7 + HB@[2, 7]:26 + HB@[2, 8]:6 + HB@[2, 9]:5 + <span style=""color:#F80000;"">KB@[2, 1, 1]:20</span> + <span style=""color:#F80000;"">KB@[2, 3, 1]:3</span>",1,3
128,1000496,UR166,658,True,False,1016095,0,4,"AB@[1, 1]:38 + AB@[1, 2]:273 + AB@[1, 3]:258 + AB@[1, 4]:89",1016096,1,1,"AB@[2, 1]:658",1,3
129,1000496,UR166,612,True,False,1016099,4,1,"AB@[5, 1]:612",1016100,5,4,"BG@[6, 1]:38 + LC@[6, 2]:169 + BG@[6, 3]:319 + BG@[6, 4]:86",1,3
130,1000496,UR166,805,True,False,1016101,6,4,"AB@[7, 1]:56 + AB@[7, 2]:250 + AB@[7, 3]:365 + AB@[7, 4]:134",1016102,7,1,"AB@[8, 1]:805",1,3
131,1000479,UR172,29,False,False,1015815,3,4,"YB@[4, 1]:20 + AB@[4, 2]:3 + KB@[4, 3]:1 + YB:AB@[4, 4]:5",1015816,4,4,"YB@[5, 1]:20 + AB@[5, 2]:4 + KB@[5, 3]:0 + YB:AB@[5, 4]:5",1,0
132,1000497,UR186,89,True,False,1016109,2,1,"AB@[3, 1]:89",1016113,6,8,"W:BG@[7, 1]:12 + W:BG@[7, 2]:4 + W:BG@[7, 3]:38 + W:BG@[7, 4]:19 + W:BG@[7, 5]:0 + W:BG@[7, 6]:2 + <span style=""color:#F80000;"">W@[7, 3, 1]:4</span> + <span style=""color:#F80000;"">W@[7, 5, 1]:10</span>",4,7
133,1000497,UR186,596,True,False,1016122,15,6,"W@[16, 1]:134 + W@[16, 2]:81 + W@[16, 3]:251 + W@[16, 4]:97 + W@[16, 5]:19 + W@[16, 6]:14",1016123,16,1,"W:BL@[17, 1]:596",1,5
134,1000506,UR195,36,False,False,1016536,23,4,"W@[24, 1]:15 + MB@[24, 2]:12 + <span style=""color:#F80000;"">LG@[24, 1, 1]:6</span> + <span style=""color:#F80000;"">LG@[24, 2, 1]:3</span>",1016537,24,15,"AB@[25, 1]:1 + AB@[25, 2]:2 + AB@[25, 3]:4 + AB@[25, 4]:1 + AB@[25, 5]:2 + AB@[25, 6]:4 + AB@[25, 7]:2 + AB@[25, 8]:4 + AB@[25, 9]:1 + <span style=""color:#F80000;"">GG@[25, 1, 1]:3</span> + <span style=""color:#F80000;"">GG@[25, 2, 1]:2</span> + <span style=""color:#F80000;"">W:GG@[25, 4, 1]:3</span> + <span style=""color:#F80000;"">GG@[25, 5, 1]:2</span> + <span style=""color:#F80000;"">GG@[25, 7, 1]:2</span> + <span style=""color:#F80000;"">W:GG@[25, 9, 1]:3</span>",1,11
135,1000507,UR196,24,False,False,1016593,1,7,"GL@[2, 1]:12 + AB@[2, 2]:4 + KB@[2, 3]:0 + GL:MB@[2, 4]:4 + W-AB-KB@[2, 5]:3 + AB@[2, 6]:0 + <span style=""color:#F80000;"">AB@[2, 1, 1]:1</span>",1016596,5,14,"W@[6, 1]:3 + W@[6, 2]:0 + W@[6, 3]:3 + W@[6, 4]:8 + W@[6, 5]:3 + <span style=""color:#F80000;"">W@[6, 1, 1]:0</span> + <span style=""color:#F80000;"">W:MB@[6, 1, 2]:2</span> + <span style=""color:#F80000;"">W@[6, 2, 1]:0</span> + <span style=""color:#F80000;"">W:MB@[6, 2, 2]:0</span> + <span style=""color:#F80000;"">W@[6, 3, 1]:1</span> + <span style=""color:#F80000;"">W:AB:MB@[6, 3, 2]:3</span> + <span style=""color:#F80000;"">W:MB@[6, 4, 1]:0</span> + <span style=""color:#F80000;"">W@[6, 5, 1]:1</span> + <span style=""color:#F80000;"">W:MB@[6, 5, 2]:0</span>",4,7
136,1000509,UR198,22,False,False,1016692,1,5,"MB@[2, 1]:1 + AB-MB@[2, 2]:0 + AB-MB@[2, 3]:17 + AB-MB@[2, 4]:0 + <span style=""color:#F80000;"">W@[2, 3, 1]:4</span>",1016695,4,10,"W:AB@[5, 1]:1 + W:AB@[5, 2]:2 + W:AB@[5, 3]:10 + W:AB@[5, 4]:1 + <span style=""color:#F80000;"">AB@[5, 2, 1]:1</span> + <span style=""color:#F80000;"">MB@[5, 2, 1, 1]:1</span> + <span style=""color:#F80000;"">W:MB@[5, 2, 3]:0</span> + <span style=""color:#F80000;"">W:AB@[5, 2, 4]:1</span> + <span style=""color:#F80000;"">MB:HB@[5, 3, 1]:4</span> + <span style=""color:#F80000;"">HB@[5, 3, 2]:1</span>",3,5
137,1000509,UR198,23,False,False,1016699,8,9,"MB@[9, 1]:0 + MB@[9, 2]:1 + MB@[9, 3]:10 + MB@[9, 4]:2 + <span style=""color:#F80000;"">W:MB@[9, 2, 1]:3</span> + <span style=""color:#F80000;"">MB@[9, 2, 2]:1</span> + <span style=""color:#F80000;"">AB:MB@[9, 2, 3]:0</span> + <span style=""color:#F80000;"">AB:MB@[9, 2, 3, 1]:1</span> + <span style=""color:#F80000;"">AB@[9, 3, 1]:5</span>",1016706,15,6,"AB@[16, 1]:1 + AB@[16, 2]:0 + AB@[16, 3]:14 + AB@[16, 4]:3 + <span style=""color:#F80000;"">MB:HB@[16, 3, 1]:2</span> + <span style=""color:#F80000;"">AB@[16, 3, 2]:3</span>",7,3
138,1000509,UR198,25,False,False,1016701,10,6,"W:AB@[11, 1]:1 + W:AB@[11, 2]:2 + W:AB@[11, 3]:17 + W:AB@[11, 4]:2 + <span style=""color:#F80000;"">AB@[11, 2, 1]:1</span> + <span style=""color:#F80000;"">W:AB@[11, 3, 1]:2</span>",1016704,13,6,"AB@[14, 1]:1 + AB@[14, 2]:1 + AB@[14, 3]:14 + AB@[14, 4]:2 + <span style=""color:#F80000;"">W:MB@[14, 3, 1]:2</span> + <span style=""color:#F80000;"">AB@[14, 3, 2]:5</span>",3,0
139,1000509,UR198,58,False,False,1016712,21,16,"W:MB@[22, 1]:1 + W:MB@[22, 2]:4 + W:MB@[22, 3]:0 + W:MB@[22, 4]:13 + W:MB@[22, 5]:2 + W:MB@[22, 6]:2 + AB-MB@[22, 7]:1 + AB-MB@[22, 8]:1 + AB-MB@[22, 9]:3 + AB-MB@[22, 10]:19 + AB-KB@[22, 11]:4 + AB-MB@[22, 12]:3 + <span style=""color:#F80000;"">W:AB@[22, 6, 1]:1</span> + <span style=""color:#F80000;"">W:AB@[22, 9, 1]:1</span> + <span style=""color:#F80000;"">HB@[22, 10, 1]:2</span> + <span style=""color:#F80000;"">W:KB@[22, 10, 2]:1</span>",1016714,23,22,"W:AB@[24, 1]:1 + W:AB@[24, 2]:1 + W:AB@[24, 3]:2 + W:AB@[24, 4]:12 + W:AB@[24, 5]:1 + W:AB@[24, 6]:1 + W:AB@[24, 7]:1 + W:AB@[24, 8]:1 + W:MB@[24, 9]:2 + W:AB@[24, 10]:11 + W:AB@[24, 11]:1 + W:AB@[24, 12]:3 + W:MB@[24, 13]:1 + W:MB@[24, 14]:0 + W:MB@[24, 15]:0 + W:MB@[24, 16]:12 + AB:MB@[24, 17]:0 + AB:MB@[24, 18]:2 + <span style=""color:#F80000;"">W:MB@[24, 3, 1]:1</span> + <span style=""color:#F80000;"">W:MB@[24, 8, 1]:1</span> + <span style=""color:#F80000;"">HB@[24, 10, 1]:2</span> + <span style=""color:#F80000;"">HB@[24, 16, 1]:2</span>",2,6
140,1000510,UR199,51,False,False,1016723,1,5,"AB:GG:MB@[2, 1]:4 + W:MB@[2, 2]:8 + W@[2, 3]:33 + KB@[2, 4]:0 + W-MB@[2, 5]:6",1016724,2,5,"AB:MB@[3, 1]:4 + W:MB@[3, 2]:8 + W@[3, 3]:33 + KB@[3, 4]:0 + W-MB@[3, 5]:6",1,0
141,1000510,UR199,58,False,False,1016726,4,5,"MB:HB@[5, 1]:5 + W:MB@[5, 2]:8 + W@[5, 3]:33 + KB@[5, 4]:4 + W-MB@[5, 5]:8",1016727,5,5,"MB:HB@[6, 1]:5 + W:MB@[6, 2]:9 + W@[6, 3]:33 + KB@[6, 4]:3 + W-MB@[6, 5]:8",1,0
142,1000510,UR199,69,False,False,1016730,8,3,"HB@[9, 1]:2 + MB@[9, 2]:56 + W@[9, 3]:11",1016731,9,4,"HB@[10, 1]:2 + KB@[10, 2]:0 + MB@[10, 3]:56 + W@[10, 4]:11",1,1
143,1000510,UR199,94,False,False,1016732,10,4,"HB@[11, 1]:4 + KB@[11, 2]:0 + MB@[11, 3]:68 + W@[11, 4]:22",1016741,19,10,"MB:HB@[20, 1]:3 + W:MB@[20, 2]:6 + W@[20, 3]:33 + MB@[20, 4]:3 + W-MB@[20, 5]:0 + MB:HB@[20, 6]:3 + W:MB@[20, 7]:6 + W@[20, 8]:30 + MB@[20, 9]:3 + W-MB@[20, 10]:7",9,6
144,1000515,UR204,100,False,False,1017104,4,5,"G0@[5, 1]:50 + AB@[5, 2]:50 + W@[5, 3]:0 + <span style=""color:#F80000;"">MB@[5, 3, 1]:0</span> + <span style=""color:#F80000;"">W:AB@[5, 3, 2]:0</span>",1017112,12,2,"W:KB@[13, 1]:50 + <span style=""color:#F80000;"">G0@[13, 1, 1]:50</span>",8,3
145,1000519,UR208,72,False,False,1017244,15,6,"MB@[16, 1]:52 + RL:PR@[16, 2]:20 + W:MB@[16, 3]:0 + HB@[16, 4]:0 + W:KB@[16, 5]:0 + <span style=""color:#F80000;"">W:MB@[16, 2, 1]:0</span>",1017245,16,4,"MB@[17, 1]:52 + RL:PR@[17, 2]:20 + W:MB@[17, 3]:0 + <span style=""color:#F80000;"">W:MB@[17, 2, 1]:0</span>",1,2
146,1000519,UR208,100,False,False,1017255,26,7,"RB@[27, 1]:80 + RB@[27, 2]:0 + W:RB@[27, 3]:0 + HB@[27, 4]:0 + KB@[27, 5]:0 + <span style=""color:#F80000;"">W:MB@[27, 2, 1]:0</span> + <span style=""color:#F80000;"">W:AB@[27, 5, 1]:20</span>",1017259,30,6,"HB@[31, 1]:80 + MB:KB@[31, 2]:20 + AB-KB@[31, 3]:0 + W:AB@[31, 4]:0 + W:KB@[31, 5]:0 + <span style=""color:#F80000;"">W:RL@[31, 2, 1]:0</span>",4,1
147,1000521,UR210,317,False,False,1017336,2,11,"W@[3, 1]:0 + KB@[3, 2]:0 + W:RL@[3, 3]:0 + W@[3, 4]:0 + KB@[3, 5]:0 + W:RL@[3, 6]:0 + W@[3, 7]:4 + KB@[3, 8]:0 + W:AB@[3, 9]:0 + W@[3, 10]:311 + W:AB@[3, 11]:2",1017337,3,12,"W@[4, 1]:1 + MB@[4, 2]:0 + W:AB@[4, 3]:0 + W@[4, 4]:1 + KB@[4, 5]:0 + W:AB@[4, 6]:0 + W@[4, 7]:4 + KB@[4, 8]:0 + W:AB@[4, 9]:0 + W@[4, 10]:308 + KB@[4, 11]:1 + W:AB@[4, 12]:2",1,1
148,1000522,UR211,160,False,False,1017356,7,7,"RB@[8, 1]:10 + RB@[8, 2]:0 + RB@[8, 3]:10 + RB@[8, 4]:110 + RB@[8, 5]:10 + RB@[8, 6]:10 + RB@[8, 7]:10",1017366,17,7,"HB@[18, 1]:40 + HB@[18, 2]:30 + HB@[18, 3]:30 + HB@[18, 4]:0 + HB@[18, 5]:30 + HB@[18, 6]:0 + HB@[18, 7]:30",10,0
149,1000523,UR212,270,False,False,1017379,11,14,"MB@[12, 1]:148 + AB:MB@[12, 2]:49 + AB:CB@[12, 3]:0 + AB:MB@[12, 4]:4 + AB:MB@[12, 5]:6 + MB@[12, 6]:7 + MB@[12, 7]:6 + MB@[12, 8]:6 + AB:MB@[12, 9]:4 + MB@[12, 10]:2 + AB:MB@[12, 11]:1 + MB@[12, 12]:2 + MB@[12, 13]:35 + AB:MB@[12, 14]:0",1017381,13,15,"MB@[14, 1]:31 + MB@[14, 2]:64 + AB:CB@[14, 3]:36 + AB:MB@[14, 4]:22 + MB@[14, 5]:31 + MB@[14, 6]:17 + AB:MB@[14, 7]:8 + MB@[14, 8]:7 + MB@[14, 9]:7 + AB:MB@[14, 10]:4 + MB@[14, 11]:12 + AB:MB@[14, 12]:11 + MB@[14, 13]:0 + AB:MB@[14, 14]:0 + <span style=""color:#F80000;"">AB@[14, 1, 1]:20</span>",2,1
150,1000534,UR223,200,False,False,1017691,2,9,"MB@[3, 1]:110 + MB@[3, 2]:6 + W-KB@[3, 3]:0 + MB-KB@[3, 4]:0 + MB@[3, 5]:10 + MB@[3, 6]:27 + MB@[3, 7]:15 + MB@[3, 8]:25 + MB@[3, 9]:7",1017693,4,9,"MB@[5, 1]:80 + MB@[5, 2]:12 + W-KB@[5, 3]:15 + KB@[5, 4]:0 + MB@[5, 5]:15 + MB@[5, 6]:25 + MB@[5, 7]:15 + MB@[5, 8]:25 + MB@[5, 9]:13",2,0
151,1000538,UR228,100,False,False,1017739,4,2,"W:MB@[5, 1]:50 + BG@[5, 2]:50",1017746,11,2,"W:MB@[12, 1]:10 + BG@[12, 2]:90",7,0
152,1000541,UR231,34,False,False,1017827,12,11,"AB:MB@[13, 1]:34 + AB:MB@[13, 2]:0 + AB:MB@[13, 3]:0 + AB:MB@[13, 4]:0 + AB:MB@[13, 5]:0 + AB:MB@[13, 6]:0 + AB:MB@[13, 7]:0 + AB:MB@[13, 8]:0 + AB:MB@[13, 9]:0 + AB:MB@[13, 10]:0 + AB:MB@[13, 11]:0",1017867,52,11,"YB:MB@[53, 1]:34 + YB:MB@[53, 2]:0 + YB:MB@[53, 3]:0 + YB:MB@[53, 4]:0 + YB:MB@[53, 5]:0 + YB:MB@[53, 6]:0 + YB:MB@[53, 7]:0 + YB:MB@[53, 8]:0 + YB:MB@[53, 9]:0 + YB:MB@[53, 10]:0 + YB:MB@[53, 11]:0",40,0
153,1000542,UR232,149,False,False,1017996,10,6,"W@[11, 1]:7 + RB@[11, 2]:0 + AB@[11, 3]:76 + MB:KB@[11, 4]:0 + RL@[11, 5]:50 + W:LG@[11, 6]:16",1017999,13,6,"W@[14, 1]:10 + RB@[14, 2]:11 + GG@[14, 3]:68 + MB:KB@[14, 4]:0 + AB@[14, 5]:0 + LG:AB@[14, 6]:60",3,0
154,1000547,UR242,33,False,False,1018227,2,8,"W:MB@[3, 1]:2 + W:MB@[3, 2]:0 + W:MB@[3, 3]:2 + AB:MB@[3, 4]:16 + AB:MB@[3, 5]:3 + AB:MB@[3, 6]:1 + AB:MB@[3, 7]:9 + AB:MB@[3, 8]:0",1018228,3,8,"AB:MB@[4, 1]:2 + AB:MB@[4, 2]:3 + AB:MB@[4, 3]:1 + AB:MB@[4, 4]:15 + AB:MB@[4, 5]:2 + AB:MB@[4, 6]:2 + AB:MB@[4, 7]:7 + AB:MB@[4, 8]:1",1,0
155,1000547,UR242,26,False,False,1018236,11,8,"W:AB@[12, 1]:3 + W:AB@[12, 2]:3 + W:AB@[12, 3]:0 + W:AB@[12, 4]:13 + W:AB@[12, 5]:1 + W:AB@[12, 6]:1 + W:AB@[12, 7]:4 + W:AB@[12, 8]:1",1018243,18,8,"W:AB@[19, 1]:3 + W:KB@[19, 2]:0 + W:KB@[19, 3]:0 + W:KB@[19, 4]:22 + AB:KB@[19, 5]:0 + AB:KB@[19, 6]:0 + W:AB@[19, 7]:0 + W:AB@[19, 8]:1",7,0
156,1000555,UR244,27,False,False,1018404,7,8,"W@[8, 1]:1 + W@[8, 2]:5 + W@[8, 3]:3 + W@[8, 4]:3 + W@[8, 5]:13 + W@[8, 6]:1 + W@[8, 7]:0 + W@[8, 8]:1",1018405,8,8,"W:MB@[9, 1]:1 + KB@[9, 2]:10 + W:MB@[9, 3]:0 + KB@[9, 4]:0 + W:MB@[9, 5]:10 + W:MB@[9, 6]:4 + W:MB@[9, 7]:2 + W:MB@[9, 8]:0",1,0
157,1000556,UR246,288,True,False,1018413,4,8,"AB@[5, 1]:8 + AB@[5, 2]:91 + AB@[5, 3]:6 + AB@[5, 4]:7 + AB@[5, 5]:147 + AB@[5, 6]:9 + AB@[5, 7]:11 + AB@[5, 8]:9",1018414,5,1,"AB@[6, 1]:288",1,7
158,1000597,UR255,100,False,False,1018898,1,2,"MB@[2, 1]:0 + AB@[2, 2]:100",1018903,6,3,"AB@[7, 1]:85 + AB@[7, 2]:0 + AB@[7, 3]:15",5,1
159,1000604,UR263,22,False,False,1018981,3,3,"W:GG@[4, 1]:12 + NB@[4, 2]:9 + W:AB@[4, 3]:1",1019034,56,15,"AB@[57, 1]:0 + MB@[57, 2]:2 + NB@[57, 3]:5 + KB@[57, 4]:0 + W:AB@[57, 5]:0 + MB@[57, 6]:3 + MB@[57, 7]:0 + KB@[57, 8]:0 + W:AB@[57, 9]:0 + AB@[57, 10]:0 + AB@[57, 11]:1 + NB@[57, 12]:8 + MB@[57, 13]:0 + KB@[57, 14]:0 + AB@[57, 15]:3",53,12
160,1000605,UR264,172,False,False,1019054,15,11,"MB@[16, 1]:0 + AB@[16, 2]:23 + MB@[16, 3]:25 + AB@[16, 4]:1 + AB:KB@[16, 5]:93 + AB@[16, 6]:0 + MB@[16, 7]:0 + AB@[16, 8]:11 + MB@[16, 9]:9 + MB@[16, 10]:10 + AB:MB@[16, 11]:0",1019060,21,4,"W@[22, 1]:18 + AB@[22, 2]:19 + W:AB@[22, 3]:14 + W:PB@[22, 4]:121",6,7
161,1000605,UR264,51,False,False,1019061,22,4,"W@[23, 1]:0 + 0B@[23, 2]:20 + W:MB@[23, 3]:10 + W:MB@[23, 4]:21",1019065,26,3,"W@[27, 1]:13 + NB@[27, 2]:23 + W:AB@[27, 3]:15",4,1
162,1000605,UR264,185,False,False,1019066,27,4,"NB@[28, 1]:154 + W@[28, 2]:2 + AB@[28, 3]:20 + W:AB@[28, 4]:9",1019067,28,4,"AB@[29, 1]:110 + W@[29, 2]:2 + AB@[29, 3]:57 + W:AB@[29, 4]:16",1,0
163,1000608,UR267A,127,False,False,1019127,1,3,"W@[2, 1]:112 + W@[2, 2]:15 + AB:MB@[2, 3]:0",1019138,12,4,"W@[13, 1]:95 + W@[13, 2]:15 + AB@[13, 3]:17 + AB:MB@[13, 4]:0",11,1
164,1000608,UR267A,282,False,False,1019137,11,3,"W@[12, 1]:187 + W@[12, 2]:15 + AB:MB@[12, 3]:80",1019142,16,3,"W@[17, 1]:141 + W@[17, 2]:15 + AB@[17, 3]:126",5,0
165,1000611,UR269,3000,False,False,1019231,14,5,"W@[15, 1]:1600 + NB@[15, 2]:1300 + MB@[15, 3]:100 + W@[15, 4]:0 + W:AB@[15, 5]:0",1019306,89,3,"AB@[90, 1]:2000 + AB@[90, 2]:0 + AB@[90, 3]:1000",75,2
166,1000611,UR269,46,False,False,1019242,25,1,"MB@[26, 1]:46",1019261,44,2,"W@[45, 1]:0 + NB@[45, 2]:46",19,1
167,1000611,UR269,1000,False,False,1019259,42,1,"MB@[43, 1]:1000",1019287,70,3,"W@[71, 1]:0 + AB@[71, 2]:0 + NB@[71, 3]:1000",28,2
168,1000615,UR273A,448,False,False,1019396,11,4,"W@[12, 1]:448 + NB@[12, 2]:0 + MB@[12, 3]:0 + KB@[12, 4]:0",1019398,13,3,"W@[14, 1]:448 + NB@[14, 2]:0 + NB@[14, 3]:0",2,1
169,1000616,UR273B,1370,False,False,1019435,15,4,"W@[16, 1]:1370 + 0B@[16, 2]:0 + 0B@[16, 3]:0 + W-KB@[16, 4]:0",1019442,22,3,"W@[23, 1]:1370 + AB@[23, 2]:0 + AB@[23, 3]:0",7,1
170,1000622,UR277,199,False,False,1019553,3,8,"W@[4, 1]:32 + W@[4, 2]:22 + W@[4, 3]:30 + W@[4, 4]:33 + W@[4, 5]:26 + AB@[4, 6]:11 + W@[4, 7]:21 + W@[4, 8]:24",1019554,4,11,"AB@[5, 1]:22 + AB@[5, 2]:22 + AB@[5, 3]:17 + NB@[5, 4]:20 + NB@[5, 5]:20 + W:NB@[5, 6]:14 + NB@[5, 7]:19 + AB:NB@[5, 8]:20 + W:NB@[5, 9]:15 + W:NB@[5, 10]:12 + NB@[5, 11]:18",1,3
171,1000650,UR283,65,False,False,1019764,0,18,"W@[1, 1]:7 + AB@[1, 2]:7 + HB@[1, 3]:12 + AB@[1, 4]:4 + W-YY@[1, 5]:2 + W-MB@[1, 6]:2 + AB-GG@[1, 7]:10 + W-MB@[1, 8]:2 + BG-HB@[1, 9]:3 + W:YY@[1, 10]:2 + HB@[1, 11]:2 + W:HB@[1, 12]:2 + W:HB@[1, 13]:2 + HB@[1, 14]:0 + AB@[1, 15]:5 + BL:AB:BD@[1, 16]:3 + BL@[1, 17]:0 + BL-AB@[1, 18]:0",1019769,5,19,"AB@[6, 1]:1 + AB@[6, 2]:2 + AB@[6, 3]:10 + LB@[6, 4]:1 + LB@[6, 5]:1 + LB@[6, 6]:10 + W@[6, 7]:1 + W@[6, 8]:1 + W@[6, 9]:10 + GG@[6, 10]:1 + GG@[6, 11]:1 + GG@[6, 12]:10 + BG@[6, 13]:1 + BG@[6, 14]:1 + BG@[6, 15]:5 + AB@[6, 16]:1 + AB@[6, 17]:1 + AB@[6, 18]:6 + MB@[6, 19]:1",5,1
172,1000650,UR283,128,False,False,1019768,4,16,"YB@[5, 1]:10 + AB@[5, 2]:11 + W-MB@[5, 3]:11 + W@[5, 4]:1 + W@[5, 5]:1 + W-BY@[5, 6]:1 + YB@[5, 7]:2 + W@[5, 8]:1 + W:MB@[5, 9]:1 + W@[5, 10]:1 + W@[5, 11]:2 + W:MB@[5, 12]:1 + W-MB@[5, 13]:7 + GG@[5, 14]:10 + AB@[5, 15]:8 + W@[5, 16]:60",1019770,6,13,"MB-KB@[7, 1]:10 + MB@[7, 2]:10 + W@[7, 3]:10 + W@[7, 4]:9 + W-MB@[7, 5]:10 + W:MB@[7, 6]:8 + BG:MB@[7, 7]:9 + W@[7, 8]:10 + AB@[7, 9]:9 + W:KB@[7, 10]:11 + W@[7, 11]:17 + AB@[7, 12]:8 + BG@[7, 13]:7",2,3
173,1000658,UR291A,48,False,False,1019813,2,11,"W@[3, 1]:10 + KB@[3, 2]:0 + NB@[3, 3]:0 + GL@[3, 4]:17 + NB@[3, 5]:6 + W:NB@[3, 6]:0 + W-BG@[3, 7]:7 + W@[3, 8]:0 + W:NB@[3, 9]:4 + W@[3, 10]:0 + W-BG@[3, 11]:4",1019817,6,10,"W:NB@[7, 1]:10 + KB@[7, 2]:0 + W@[7, 3]:5 + GL@[7, 4]:0 + W:BG@[7, 5]:4 + W:MB@[7, 6]:0 + W@[7, 7]:0 + W:NB@[7, 8]:3 + W:NB@[7, 9]:17 + W-BG@[7, 10]:9",4,1
174,1000658,UR291A,43,False,False,1019814,3,13,"W@[4, 1]:0 + KB@[4, 2]:0 + AB@[4, 3]:0 + GL@[4, 4]:7 + NB@[4, 5]:0 + W:NB@[4, 6]:0 + W@[4, 7]:4 + W:KB@[4, 8]:2 + W@[4, 9]:0 + KB@[4, 10]:10 + W@[4, 11]:11 + KB@[4, 12]:0 + W-BG@[4, 13]:9",1019819,8,10,"W@[9, 1]:10 + KB@[9, 2]:0 + W:NB@[9, 3]:8 + GL@[9, 4]:2 + AB:NB@[9, 5]:3 + W:NB@[9, 6]:0 + W:NB@[9, 7]:16 + W@[9, 8]:0 + W@[9, 9]:0 + W-BG@[9, 10]:4",5,3
175,6000002,AS003,82,True,False,6000021,0,7,"W:LB@[1, 1]:4 + W:LB@[1, 2]:10 + W:LB@[1, 3]:37 + W:LB@[1, 4]:7 + W:LB@[1, 5]:14 + W:LB@[1, 6]:4 + <span style=""color:#F80000;"">W:LB@[1, 5, 1]:6</span>",6000022,1,2,"W:LB@[2, 1]:76 + W:LB@[2, 1, 1]:6",1,5
176,6000005,AS006,105,True,False,6000060,0,6,"W@[1, 1]:5 + W@[1, 2]:24 + W@[1, 3]:9 + W:MB@[1, 4]:47 + W:MB@[1, 5]:10 + W:MB@[1, 6]:10",6000061,1,1,"W:MB@[2, 1]:105",1,5
177,6000005,AS006,158,True,False,6000065,5,6,"MB@[6, 1]:127 + W@[6, 1, 1]:8 + MB@[6, 1, 2]:6 + W:MB@[6, 1, 3]:5 + MB@[6, 1, 4]:9 + W:MB@[6, 1, 5]:3",6000066,6,12,"MB@[7, 1]:7 + MB@[7, 2]:38 + MB@[7, 3]:14 + W@[7, 4]:57 + W@[7, 5]:8 + W@[7, 6]:14 + <span style=""color:#F80000;"">MB@[7, 3, 1]:1</span> + <span style=""color:#F80000;"">MB@[7, 3, 2]:1</span> + <span style=""color:#F80000;"">MB@[7, 3, 3]:1</span> + <span style=""color:#F80000;"">MB@[7, 3, 4]:0</span> + <span style=""color:#F80000;"">MB@[7, 3, 5]:16</span> + <span style=""color:#F80000;"">MB@[7, 4, 1]:1</span>",1,6
178,6000005,AS006,147,True,False,6000067,7,6,"MB@[8, 1]:138 + MB@[8, 1, 1]:3 + W@[8, 1, 2]:4 + W@[8, 1, 3]:1 + MB@[8, 1, 4]:1 + PK@[8, 1, 5]:0",6000069,9,5,"W@[10, 1]:140 + W@[10, 1, 1]:1 + GR@[10, 1, 2]:3 + MB@[10, 1, 3]:1 + MB@[10, 1, 4]:2",2,1
179,6000006,AS007,132,True,False,6000097,4,7,"W:GR@[5, 1]:4 + W:GR@[5, 2]:47 + W:GR@[5, 3]:17 + W:MB@[5, 4]:50 + W:MB@[5, 5]:3 + W:MB@[5, 6]:10 + <span style=""color:#F80000;"">W@[5, 2, 1]:1</span>",6000098,5,2,"W:GR@[6, 1]:131 + W@[6, 1, 1]:1",1,5
180,6000006,AS007,170,True,False,6000110,17,1,"W:DB@[18, 1]:170",6000111,18,10,"W:MB@[19, 1]:5 + W:MB@[19, 2]:56 + W:MB@[19, 3]:14 + W:MB@[19, 4]:0 + W:MB@[19, 5]:60 + W:MB@[19, 6]:16 + W:MB@[19, 7]:17 + W:MB@[19, 8]:0 + <span style=""color:#F80000;"">LB@[19, 3, 1]:1</span> + <span style=""color:#F80000;"">W:MB@[19, 6, 1]:1</span>",1,9
181,6000006,AS007,124,True,False,6000119,26,6,"MB@[27, 1]:11 + MB@[27, 2]:4 + MB@[27, 3]:48 + MB@[27, 4]:11 + MB@[27, 5]:46 + MB@[27, 6]:4",6000120,27,1,"MB@[28, 1]:124",1,5
182,6000007,AS008,331,False,False,6000149,2,1,"W@[3, 1]:331",6000161,14,4,"W:DB@[15, 1]:0 + W:MB@[15, 2]:0 + MB@[15, 3]:0 + W:MB@[15, 4]:331",12,3
183,6000013,HP055,42,False,False,6000309,4,2,"MB@[5, 1]:42 + MB@[5, 2]:0",6000313,8,1,"MB@[9, 1]:42",4,1
184,6000013,HP055,1656,False,False,6000310,5,11,"W@[6, 1]:1078 + W-MB@[6, 2]:10 + W@[6, 3]:21 + W:BL@[6, 4]:100 + W-MB@[6, 5]:40 + W:AB@[6, 6]:222 + W:MB@[6, 7]:23 + W:BL@[6, 8]:33 + W@[6, 9]:66 + PG@[6, 10]:30 + W:PG@[6, 11]:33",6000320,15,11,"W@[16, 1]:1089 + W-MB@[16, 2]:12 + W:BL@[16, 3]:0 + W:BL@[16, 4]:100 + W-MB@[16, 5]:50 + W:AB@[16, 6]:222 + W:MB@[16, 7]:22 + W:BL@[16, 8]:32 + W@[16, 9]:66 + PG:MB@[16, 10]:30 + W:PG@[16, 11]:33",10,0
185,6000013,HP055,43,False,True,6000315,10,1,"MB@[11, 1]:43",6000319,14,1,"MB@[15, 1]:43",4,0
186,6000013,HP055,42,False,False,6000321,16,2,"MB@[17, 1]:0 + MB@[17, 2]:42",6000323,18,1,"MB@[19, 1]:42",2,1
187,6000013,HP055,42,False,False,6000327,22,1,"AB@[23, 1]:42",6000330,25,2,"AB@[26, 1]:42 + MB@[26, 2]:0",3,1
188,6000018,KH0057,43,False,False,6000516,16,5,"AB@[17, 1]:33 + W@[17, 2]:0 + <span style=""color:#F80000;"">0B@[17, 1, 1]:0</span> + <span style=""color:#F80000;"">W@[17, 1, 2]:10</span> + <span style=""color:#F80000;"">MB@[17, 2, 1]:0</span>",6000518,18,4,"BG@[19, 1]:11 + MB@[19, 2]:24 + <span style=""color:#F80000;"">W@[19, 2, 1]:8</span> + <span style=""color:#F80000;"">0B@[19, 2, 2]:0</span>",2,1
189,6000023,KH0083,49,False,False,6000704,5,10,"W:AB@[6, 1]:0 + <span style=""color:#F80000;"">W@[6, 1, 1]:15</span> + <span style=""color:#F80000;"">W@[6, 1, 1, 1]:0</span> + <span style=""color:#F80000;"">W-DB@[6, 1, 1, 1, 1]:0</span> + <span style=""color:#F80000;"">W-HB@[6, 1, 1, 1, 1, 1]:0</span> + <span style=""color:#F80000;"">DB@[6, 1, 1, 1, 1, 1, 1]:5</span> + <span style=""color:#F80000;"">HB@[6, 1, 1, 1, 4]:17</span> + <span style=""color:#F80000;"">DB@[6, 1, 1, 6]:11</span> + <span style=""color:#F80000;"">W@[6, 1, 8]:0</span> + <span style=""color:#F80000;"">W:HB@[6, 1, 8, 1]:1</span>",6000721,22,9,"AB@[23, 1]:0 + <span style=""color:#F80000;"">W@[23, 1, 1]:0</span> + <span style=""color:#F80000;"">W@[23, 1, 1, 1]:22</span> + <span style=""color:#F80000;"">W@[23, 1, 3]:0</span> + <span style=""color:#F80000;"">W@[23, 1, 3, 1]:0</span> + <span style=""color:#F80000;"">W@[23, 1, 3, 1, 1]:1</span> + <span style=""color:#F80000;"">W-DB@[23, 1, 3, 3]:0</span> + <span style=""color:#F80000;"">W@[23, 1, 3, 4]:10</span> + <span style=""color:#F80000;"">W@[23, 1, 8]:16</span>",17,1
190,6000023,KH0083,140,False,False,6000713,14,7,"AB@[15, 1]:30 + <span style=""color:#F80000;"">W@[15, 1, 1]:60</span> + <span style=""color:#F80000;"">HB@[15, 1, 1, 1]:2</span> + <span style=""color:#F80000;"">W@[15, 1, 3]:41</span> + <span style=""color:#F80000;"">W-DB@[15, 1, 3, 1]:0</span> + <span style=""color:#F80000;"">GA@[15, 1, 3, 1, 1]:5</span> + <span style=""color:#F80000;"">GA@[15, 1, 3, 3]:2</span>",6000723,24,15,"W@[25, 1]:0 + <span style=""color:#F80000;"">AB@[25, 1, 1]:0</span> + <span style=""color:#F80000;"">W-DB@[25, 1, 1, 1]:0</span> + <span style=""color:#F80000;"">DB@[25, 1, 1, 1, 1]:2</span> + <span style=""color:#F80000;"">W@[25, 1, 1, 3]:0</span> + <span style=""color:#F80000;"">HB@[25, 1, 1, 3, 1]:12</span> + <span style=""color:#F80000;"">W:MG:LK@[25, 1, 1, 5]:71</span> + <span style=""color:#F80000;"">W@[25, 1, 7]:0</span> + <span style=""color:#F80000;"">W@[25, 1, 7, 1]:0</span> + <span style=""color:#F80000;"">W@[25, 1, 7, 1, 1]:0</span> + <span style=""color:#F80000;"">CB@[25, 1, 7, 1, 1, 1]:1</span> + <span style=""color:#F80000;"">DB@[25, 1, 7, 1, 3]:30</span> + <span style=""color:#F80000;"">W@[25, 1, 12]:0</span> + <span style=""color:#F80000;"">DB@[25, 1, 12, 1]:4</span> + <span style=""color:#F80000;"">DB@[25, 1, 14]:20</span>",10,8
191,6000023,KH0083,46,False,False,6000731,32,6,"AB@[33, 1]:0 + <span style=""color:#F80000;"">AB@[33, 1, 1]:0</span> + <span style=""color:#F80000;"">W@[33, 1, 1, 1]:30</span> + <span style=""color:#F80000;"">W-DB@[33, 1, 1, 1, 1]:1</span> + <span style=""color:#F80000;"">PK@[33, 1, 4]:0</span> + <span style=""color:#F80000;"">W@[33, 1, 5]:15</span>",6000753,54,5,"AB@[55, 1]:0 + <span style=""color:#F80000;"">W@[55, 1, 1]:1</span> + <span style=""color:#F80000;"">W-DB@[55, 1, 1, 1]:2</span> + <span style=""color:#F80000;"">W-DB@[55, 1, 3]:2</span> + <span style=""color:#F80000;"">W@[55, 1, 4]:41</span>",22,1
192,6000028,MM001,100,False,False,6001207,8,8,"PG@[9, 1]:20 + W:YB@[9, 2]:10 + W@[9, 3]:10 + YB@[9, 4]:10 + PG@[9, 5]:20 + AB@[9, 6]:10 + W@[9, 7]:10 + YB@[9, 8]:10",6001214,15,8,"YB:PG@[16, 1]:20 + YB:MB@[16, 2]:10 + W@[16, 3]:10 + YB@[16, 4]:10 + YB:PG@[16, 5]:20 + YB:MB@[16, 6]:10 + W@[16, 7]:10 + YB@[16, 8]:10",7,0
193,6000036,MM009,39,False,False,6001356,0,3,"W@[1, 1]:16 + <span style=""color:#F80000;"">AB@[1, 1, 1]:3</span> + <span style=""color:#F80000;"">W:MB@[1, 1, 2]:20</span>",6001358,2,3,"W@[3, 1]:26 + <span style=""color:#F80000;"">AB@[3, 1, 1]:3</span> + <span style=""color:#F80000;"">W:MB@[3, 1, 2]:10</span>",2,0
194,6000041,MM014,55,False,True,6001389,2,1,"LB@[3, 1]:55",6001390,3,1,"LB@[4, 1]:55",1,0
195,6000043,MM016,21,False,False,6001406,3,1,"AB@[4, 1]:21",6001409,6,2,"AB@[7, 1]:21 + <span style=""color:#F80000;"">YB@[7, 1, 1]:0</span>",3,1
196,6000046,MM019,26,False,False,6001474,23,6,"W@[24, 1]:2 + W@[24, 2]:0 + W@[24, 3]:6 + MB@[24, 4]:2 + R@[24, 5]:10 + YB@[24, 6]:6",6001486,35,9,"W@[36, 1]:2 + YB@[36, 2]:5 + YB@[36, 3]:2 + W@[36, 4]:0 + <span style=""color:#F80000;"">W@[36, 1, 1]:0</span> + <span style=""color:#F80000;"">YB@[36, 2, 1]:5</span> + <span style=""color:#F80000;"">YB@[36, 3, 1]:4</span> + <span style=""color:#F80000;"">YB@[36, 3, 1, 1]:4</span> + <span style=""color:#F80000;"">YB@[36, 3, 3]:4</span>",12,3
197,6000049,MM1086,22,False,True,6001622,10,1,"W@[11, 1]:22",6001639,27,1,"W@[28, 1]:22",17,0
198,6000049,MM1086,340,False,False,6001630,18,1,"B@[19, 1]:340",6001652,40,1,"MB@[41, 1]:340",22,0
199,6000049,MM1086,250,False,False,6001633,21,1,"AB@[22, 1]:250",6001651,39,1,"W@[40, 1]:250",18,0
200,6000051,QU002,38,False,False,6001674,4,9,"YB@[5, 1]:15 + YB@[5, 2]:2 + AB@[5, 3]:3 + AB@[5, 4]:2 + YB@[5, 5]:5 + YB@[5, 6]:4 + YB@[5, 7]:2 + YB@[5, 8]:4 + YB@[5, 9]:1",6001675,5,17,"YB@[6, 1]:15 + YB@[6, 2]:3 + AB@[6, 3]:4 + AB@[6, 4]:4 + YB@[6, 5]:3 + YB@[6, 6]:3 + YB@[6, 7]:3 + YB@[6, 8]:1 + YB@[6, 9]:2 + B@[6, 10]:0 + B@[6, 11]:0 + AB@[6, 12]:0 + B@[6, 13]:0 + B@[6, 14]:0 + B@[6, 15]:0 + B@[6, 16]:0 + B@[6, 17]:0",1,8
201,6000058,QU009,93,False,False,6001889,5,7,"YB@[6, 1]:3 + YB@[6, 2]:8 + YB@[6, 3]:18 + AB@[6, 4]:30 + AB@[6, 5]:12 + AB@[6, 6]:12 + <span style=""color:#F80000;"">AB@[6, 2, 1]:10</span>",6001891,7,9,"YB@[8, 1]:5 + YB@[8, 2]:7 + YB@[8, 3]:8 + YB:B@[8, 4]:31 + AB@[8, 5]:14 + AB@[8, 6]:18 + <span style=""color:#F80000;"">AB@[8, 2, 1]:1</span> + <span style=""color:#F80000;"">B@[8, 2, 2]:4</span> + <span style=""color:#F80000;"">YB:MB@[8, 3, 1]:5</span>",2,2
202,6000058,QU009,83,True,True,6001890,6,1,"AB@[7, 1]:83",6001892,8,1,"AB@[9, 1]:83",2,0
203,6000062,QU013,24,False,False,6002130,7,4,"YB@[8, 1]:11 + BS@[8, 2]:2 + PG@[8, 3]:3 + MB@[8, 4]:8",6002131,8,4,"YB@[9, 1]:11 + BS@[9, 2]:1 + PG@[9, 3]:4 + MB@[9, 4]:8",1,0
204,6000062,QU013,21,False,False,6002132,9,4,"YB@[10, 1]:10 + BS@[10, 2]:1 + PG@[10, 3]:2 + MB@[10, 4]:8",6002147,24,4,"MB:LK@[25, 1]:0 + YB@[25, 2]:12 + BS@[25, 3]:5 + GG@[25, 4]:4",15,0
205,6000062,QU013,22,False,False,6002143,20,4,"GG@[21, 1]:0 + YB@[21, 2]:10 + BS@[21, 3]:11 + GG@[21, 4]:1",6002145,22,4,"MB:LK@[23, 1]:0 + YB@[23, 2]:12 + BS@[23, 3]:7 + GG@[23, 4]:3",2,0
206,6000063,QU014,119,True,False,6002201,22,21,"YB@[23, 1]:19 + YB@[23, 2]:0 + YB@[23, 3]:0 + YB@[23, 4]:0 + YB@[23, 5]:2 + YB@[23, 6]:37 + YB@[23, 7]:7 + YB@[23, 8]:7 + YB@[23, 9]:43 + YB@[23, 10]:3 + YB@[23, 11]:0 + YB@[23, 12]:0 + YB:KB@[23, 13]:0 + YB:KB@[23, 14]:0 + YB:KB@[23, 15]:0 + YB:KB@[23, 16]:0 + YB:KB@[23, 17]:0 + YB:KB@[23, 18]:0 + YB:KB@[23, 19]:0 + <span style=""color:#F80000;"">KB@[23, 8, 1]:0</span> + <span style=""color:#F80000;"">YB:MB@[23, 8, 2]:1</span>",6002217,38,1,"YB:BS@[39, 1]:119",16,20
207,6000064,QU015,512,True,False,6002289,8,4,"MB@[9, 1]:100 + MB@[9, 2]:142 + YB@[9, 3]:0 + YB@[9, 4]:270",6002290,9,1,"BS@[10, 1]:512",1,3
208,6000064,QU015,46,False,False,6002299,18,6,"YB@[19, 1]:16 + YB@[19, 2]:13 + BS@[19, 3]:15 + <span style=""color:#F80000;"">MB@[19, 3, 1]:0</span> + <span style=""color:#F80000;"">YB@[19, 3, 2]:1</span> + <span style=""color:#F80000;"">YB:KB@[19, 3, 3]:1</span>",6002308,27,3,"BS@[28, 1]:30 + BS@[28, 2]:0 + BS@[28, 3]:16",9,3
209,6000068,QU019,173,True,False,6002458,10,6,"MB@[11, 1]:6 + MB@[11, 2]:46 + MB@[11, 3]:18 + YB@[11, 4]:73 + YB@[11, 5]:10 + YB@[11, 6]:20",6002459,11,1,"YB@[12, 1]:173",1,5
210,6000070,QU021,68,False,False,6002522,5,10,"YY:KB@[6, 1]:0 + YY:KB@[6, 2]:55 + YY:KB@[6, 3]:1 + YY:KB@[6, 4]:0 + YY:KB@[6, 5]:0 + YY:KB@[6, 6]:0 + YY:KB@[6, 7]:0 + YY:KB@[6, 8]:10 + <span style=""color:#F80000;"">YY:KB@[6, 2, 1]:0</span> + <span style=""color:#F80000;"">OB@[6, 2, 2]:2</span>",6002532,15,14,"YY:NB@[16, 1]:1 + YY:NB@[16, 2]:10 + YY:NB@[16, 3]:0 + YY:NB@[16, 4]:3 + YY:NB@[16, 5]:34 + YY:NB@[16, 6]:2 + YY:NB@[16, 7]:5 + YY:NB@[16, 8]:3 + <span style=""color:#F80000;"">YY:NB@[16, 3, 1]:2</span> + <span style=""color:#F80000;"">OB@[16, 3, 2]:1</span> + <span style=""color:#F80000;"">YY:BS@[16, 4, 1]:3</span> + <span style=""color:#F80000;"">KB@[16, 4, 2]:0</span> + <span style=""color:#F80000;"">YY%KB@[16, 4, 3]:1</span> + <span style=""color:#F80000;"">YY:NB@[16, 6, 1]:3</span>",10,4
211,6000070,QU021,38,False,False,6002529,12,12,"YY:BS@[13, 1]:1 + YY:BS@[13, 2]:2 + YY:BS@[13, 3]:1 + YY:BS@[13, 4]:1 + YY:BS@[13, 5]:13 + YY:BS@[13, 6]:4 + YY:BS@[13, 7]:5 + YY:BS@[13, 8]:0 + <span style=""color:#F80000;"">YY:GL@[13, 2, 1]:4</span> + <span style=""color:#F80000;"">YY:BS@[13, 4, 1]:3</span> + <span style=""color:#F80000;"">YY:KB@[13, 4, 2]:3</span> + <span style=""color:#F80000;"">YY:BS@[13, 5, 1]:1</span>",6002530,13,9,"YY@[14, 1]:1 + YY@[14, 2]:2 + YY@[14, 3]:2 + YY@[14, 4]:3 + YY@[14, 5]:25 + YY@[14, 6]:1 + YY@[14, 7]:2 + YY@[14, 8]:2 + <span style=""color:#F80000;"">YY%KB@[14, 4, 1]:0</span>",1,3
212,6000071,QU022,111,False,True,6002572,1,1,"NB@[2, 1]:111",6002573,2,1,"NB@[3, 1]:111",1,0
213,6000071,QU022,102,False,False,6002575,4,1,"B-KB@[5, 1]:102",6002576,5,1,"NB@[6, 1]:102",1,0
214,6000072,UR001,400,False,False,6002622,45,11,"W@[46, 1]:0 + W@[46, 2]:0 + W@[46, 3]:0 + MB@[46, 4]:0 + HB@[46, 5]:0 + HB@[46, 6]:0 + RL@[46, 7]:0 + W@[46, 8]:400 + <span style=""color:#F80000;"">KB@[46, 1, 1]:0</span> + <span style=""color:#F80000;"">W@[46, 1, 2]:0</span> + <span style=""color:#F80000;"">MB@[46, 1, 3]:0</span>",6002623,46,1,"W@[47, 1]:400",1,10
215,6000073,UR004,24,False,False,6002748,30,7,"MB@[31, 1]:1 + MB@[31, 2]:1 + MB@[31, 3]:1 + MB@[31, 4]:2 + G@[31, 5]:1 + MB@[31, 6]:2 + MB@[31, 7]:16",6002774,56,6,"MB@[57, 1]:1 + MB@[57, 2]:2 + AB:G@[57, 3]:3 + AB:KB@[57, 4]:0 + <span style=""color:#F80000;"">MB@[57, 1, 1]:2</span> + <span style=""color:#F80000;"">MB@[57, 2, 1]:16</span>",26,1
216,6000075,UR039,24,False,False,6002944,16,1,"AB@[17, 1]:24",6002945,17,1,"AB-B@[18, 1]:24",1,0
217,6000075,UR039,25,False,True,6002949,21,1,"AB@[22, 1]:25",6002969,41,1,"AB@[42, 1]:25",20,0
218,6000075,UR039,41,False,True,6002953,25,1,"AB@[26, 1]:41",6002989,61,1,"AB@[62, 1]:41",36,0
219,6000075,UR039,29,False,True,6002966,38,1,"AB@[39, 1]:29",6003007,79,1,"AB@[80, 1]:29",41,0
220,6000075,UR039,28,False,True,6002975,47,1,"AB@[48, 1]:28",6002992,64,1,"AB@[65, 1]:28",17,0
221,6000075,UR039,33,False,True,6002980,52,1,"AB@[53, 1]:33",6002994,66,1,"AB@[67, 1]:33",14,0
222,6000075,UR039,34,False,True,6002984,56,1,"AB@[57, 1]:34",6003016,88,1,"AB@[89, 1]:34",32,0
223,6000075,UR039,39,False,True,6002993,65,1,"AB@[66, 1]:39",6003010,82,1,"AB@[83, 1]:39",17,0
224,6000077,UR050,21,False,True,6003070,35,1,"W@[36, 1]:21",6003078,43,1,"W@[44, 1]:21",8,0
225,6000077,UR050,22,False,True,6003118,83,1,"W@[84, 1]:22",6003192,157,1,"W@[158, 1]:22",74,0
226,6000077,UR050,21,False,True,6003164,129,1,"W@[130, 1]:21",6003184,149,1,"W@[150, 1]:21",20,0
227,6000077,UR050,21,False,True,6003187,152,1,"W@[153, 1]:21",6003198,163,1,"W@[164, 1]:21",11,0
228,6000078,UR052,22,False,True,6003200,1,1,"LK@[2, 1]:22",6003203,4,1,"LK@[5, 1]:22",3,0
229,6000078,UR052,24,False,True,6003204,5,1,"LK@[6, 1]:24",6003227,28,1,"LK@[29, 1]:24",23,0
230,6000078,UR052,29,False,True,6003205,6,1,"LK@[7, 1]:29",6003291,92,1,"LK@[93, 1]:29",86,0
231,6000078,UR052,26,False,True,6003207,8,1,"LK@[9, 1]:26",6003259,60,1,"LK@[61, 1]:26",52,0
232,6000078,UR052,28,False,True,6003208,9,1,"LK@[10, 1]:28",6003217,18,1,"LK@[19, 1]:28",9,0
233,6000078,UR052,21,False,True,6003209,10,1,"LK@[11, 1]:21",6003210,11,1,"LK@[12, 1]:21",1,0
234,6000078,UR052,25,False,True,6003211,12,1,"LK@[13, 1]:25",6003219,20,1,"LK@[21, 1]:25",8,0
235,6000078,UR052,22,False,True,6003215,16,1,"LK@[17, 1]:22",6003224,25,1,"LK@[26, 1]:22",9,0
236,6000078,UR052,21,False,True,6003218,19,1,"LK@[20, 1]:21",6003268,69,1,"LK@[70, 1]:21",50,0
237,6000078,UR052,25,False,True,6003223,24,1,"LK@[25, 1]:25",6003261,62,1,"LK@[63, 1]:25",38,0
238,6000078,UR052,22,False,True,6003225,26,1,"LK@[27, 1]:22",6003229,30,1,"LK@[31, 1]:22",4,0
239,6000078,UR052,24,False,True,6003230,31,1,"LK@[32, 1]:24",6003289,90,1,"LK@[91, 1]:24",59,0
240,6000078,UR052,22,False,True,6003232,33,1,"W@[34, 1]:22",6003234,35,1,"W@[36, 1]:22",2,0
241,6000078,UR052,22,False,True,6003260,61,1,"LK@[62, 1]:22",6003264,65,1,"LK@[66, 1]:22",4,0
242,6000078,UR052,23,False,True,6003262,63,1,"LK@[64, 1]:23",6003275,76,1,"LK@[77, 1]:23",13,0
243,6000078,UR052,26,False,True,6003274,75,1,"LK@[76, 1]:26",6003288,89,1,"LK@[90, 1]:26",14,0
244,6000078,UR052,25,False,True,6003281,82,1,"LK@[83, 1]:25",6003282,83,1,"LK@[84, 1]:25",1,0
245,6000078,UR052,21,False,True,6003286,87,1,"LK@[88, 1]:21",6003287,88,1,"LK@[89, 1]:21",1,0
246,6000078,UR052,26,False,True,6003294,95,1,"LK@[96, 1]:26",6003296,97,1,"LK@[98, 1]:26",2,0
247,6000079,UR054,21,False,True,6003321,24,1,"DB@[25, 1]:21",6003326,29,1,"DB@[30, 1]:21",5,0
248,6000079,UR054,24,False,True,6003340,43,1,"DB@[44, 1]:24",6003381,84,1,"DB@[85, 1]:24",41,0
249,6000080,UR055,27,False,True,6003412,0,1,"LK@[1, 1]:27",6003471,59,1,"LK@[60, 1]:27",59,0
250,6000080,UR055,24,False,True,6003413,1,1,"LK@[2, 1]:24",6003456,44,1,"LK@[45, 1]:24",43,0
251,6000080,UR055,44,False,True,6003414,2,1,"LK@[3, 1]:44",6003454,42,1,"LK@[43, 1]:44",40,0
252,6000080,UR055,45,False,True,6003415,3,1,"LK@[4, 1]:45",6003579,167,1,"LK@[168, 1]:45",164,0
253,6000080,UR055,36,False,True,6003417,5,1,"LK@[6, 1]:36",6003431,19,1,"LK@[20, 1]:36",14,0
254,6000080,UR055,29,False,True,6003418,6,1,"LK@[7, 1]:29",6003466,54,1,"LK@[55, 1]:29",48,0
255,6000080,UR055,21,False,False,6003420,8,1,"PK@[9, 1]:21",6003422,10,1,"LK@[11, 1]:21",2,0
256,6000080,UR055,33,False,True,6003421,9,1,"LK@[10, 1]:33",6003433,21,1,"LK@[22, 1]:33",12,0
257,6000080,UR055,22,False,True,6003423,11,1,"LK@[12, 1]:22",6003444,32,1,"LK@[33, 1]:22",21,0
258,6000080,UR055,28,False,True,6003424,12,1,"LK@[13, 1]:28",6003451,39,1,"LK@[40, 1]:28",27,0
259,6000080,UR055,34,False,True,6003425,13,1,"LK@[14, 1]:34",6003430,18,1,"LK@[19, 1]:34",5,0
260,6000080,UR055,25,False,False,6003426,14,1,"LK@[15, 1]:25",6003440,28,1,"PK@[29, 1]:25",14,0
261,6000080,UR055,32,False,True,6003427,15,1,"LK@[16, 1]:32",6003435,23,1,"LK@[24, 1]:32",8,0
262,6000080,UR055,43,False,True,6003428,16,1,"LK@[17, 1]:43",6003448,36,1,"LK@[37, 1]:43",20,0
263,6000080,UR055,34,False,True,6003432,20,1,"LK@[21, 1]:34",6003445,33,1,"LK@[34, 1]:34",13,0
264,6000080,UR055,36,False,True,6003434,22,1,"LK@[23, 1]:36",6003437,25,1,"LK@[26, 1]:36",3,0
265,6000080,UR055,32,False,True,6003436,24,1,"LK@[25, 1]:32",6003450,38,1,"LK@[39, 1]:32",14,0
266,6000080,UR055,31,False,True,6003438,26,1,"LK@[27, 1]:31",6003458,46,1,"LK@[47, 1]:31",20,0
267,6000080,UR055,33,False,True,6003447,35,1,"LK@[36, 1]:33",6003453,41,1,"LK@[42, 1]:33",6,0
268,6000080,UR055,32,False,True,6003452,40,1,"LK@[41, 1]:32",6003462,50,1,"LK@[51, 1]:32",10,0
269,6000080,UR055,25,False,True,6003455,43,1,"LK@[44, 1]:25",6003460,48,1,"LK@[49, 1]:25",5,0
270,6000080,UR055,28,False,True,6003457,45,1,"LK@[46, 1]:28",6003473,61,1,"LK@[62, 1]:28",16,0
271,6000080,UR055,26,False,True,6003459,47,1,"LK@[48, 1]:26",6003463,51,1,"LK@[52, 1]:26",4,0
272,6000080,UR055,33,False,True,6003461,49,1,"LK@[50, 1]:33",6003468,56,1,"LK@[57, 1]:33",7,0
273,6000080,UR055,34,False,False,6003465,53,1,"LK@[54, 1]:34",6003472,60,1,"PK@[61, 1]:34",7,0
274,6000080,UR055,31,False,True,6003467,55,1,"LK@[56, 1]:31",6003469,57,1,"LK@[58, 1]:31",2,0
275,6000080,UR055,31,False,True,6003470,58,1,"LK@[59, 1]:31",6003529,117,1,"LK@[118, 1]:31",59,0
276,6000080,UR055,28,False,True,6003475,63,1,"LK@[64, 1]:28",6003484,72,1,"LK@[73, 1]:28",9,0
277,6000080,UR055,29,False,True,6003476,64,1,"LK@[65, 1]:29",6003480,68,1,"LK@[69, 1]:29",4,0
278,6000080,UR055,44,False,True,6003477,65,1,"LK@[66, 1]:44",6003523,111,1,"LK@[112, 1]:44",46,0
279,6000080,UR055,24,False,True,6003478,66,1,"LK@[67, 1]:24",6003498,86,1,"LK@[87, 1]:24",20,0
280,6000080,UR055,34,False,True,6003479,67,1,"LK@[68, 1]:34",6003481,69,1,"LK@[70, 1]:34",2,0
281,6000080,UR055,27,False,True,6003482,70,1,"LK@[71, 1]:27",6003521,109,1,"LK@[110, 1]:27",39,0
282,6000080,UR055,25,False,True,6003483,71,1,"LK@[72, 1]:25",6003486,74,1,"LK@[75, 1]:25",3,0
283,6000080,UR055,22,False,True,6003487,75,1,"LK@[76, 1]:22",6003500,88,1,"LK@[89, 1]:22",13,0
284,6000080,UR055,35,False,True,6003488,76,1,"LK@[77, 1]:35",6003519,107,1,"LK@[108, 1]:35",31,0
285,6000080,UR055,23,False,True,6003490,78,1,"LK@[79, 1]:23",6003510,98,1,"LK@[99, 1]:23",20,0
286,6000080,UR055,34,False,True,6003491,79,1,"LK@[80, 1]:34",6003496,84,1,"LK@[85, 1]:34",5,0
287,6000080,UR055,32,False,True,6003492,80,1,"LK@[81, 1]:32",6003532,120,1,"LK@[121, 1]:32",40,0
288,6000080,UR055,29,False,True,6003495,83,1,"LK@[84, 1]:29",6003576,164,1,"LK@[165, 1]:29",81,0
289,6000080,UR055,28,False,True,6003497,85,1,"LK@[86, 1]:28",6003513,101,1,"LK@[102, 1]:28",16,0
290,6000080,UR055,25,False,True,6003501,89,1,"LK@[90, 1]:25",6003512,100,1,"LK@[101, 1]:25",11,0
291,6000080,UR055,22,False,True,6003506,94,1,"LK@[95, 1]:22",6003508,96,1,"LK@[97, 1]:22",2,0
292,6000080,UR055,24,False,True,6003507,95,1,"LK@[96, 1]:24",6003548,136,1,"LK@[137, 1]:24",41,0
293,6000080,UR055,26,False,True,6003509,97,1,"LK@[98, 1]:26",6003515,103,1,"LK@[104, 1]:26",6,0
294,6000080,UR055,23,False,False,6003511,99,1,"LK@[100, 1]:23",6003517,105,1,"PK@[106, 1]:23",6,0
295,6000080,UR055,21,False,True,6003514,102,1,"LK@[103, 1]:21",6003533,121,1,"LK@[122, 1]:21",19,0
296,6000080,UR055,22,False,True,6003518,106,1,"LK@[107, 1]:22",6003528,116,1,"LK@[117, 1]:22",10,0
297,6000080,UR055,27,False,True,6003524,112,1,"LK@[113, 1]:27",6003525,113,1,"LK@[114, 1]:27",1,0
298,6000080,UR055,34,False,True,6003530,118,1,"LK@[119, 1]:34",6003539,127,1,"LK@[128, 1]:34",9,0
299,6000080,UR055,22,False,True,6003534,122,1,"LK@[123, 1]:22",6003540,128,1,"LK@[129, 1]:22",6,0
300,6000080,UR055,31,False,True,6003536,124,1,"LK@[125, 1]:31",6003564,152,1,"LK@[153, 1]:31",28,0
301,6000080,UR055,26,False,True,6003541,129,1,"LK@[130, 1]:26",6003555,143,1,"LK@[144, 1]:26",14,0
302,6000080,UR055,25,False,True,6003545,133,1,"LK@[134, 1]:25",6003558,146,1,"LK@[147, 1]:25",13,0
303,6000080,UR055,28,False,True,6003546,134,1,"LK@[135, 1]:28",6003557,145,1,"LK@[146, 1]:28",11,0
304,6000080,UR055,22,False,False,6003547,135,1,"LK@[136, 1]:22",6003561,149,1,"PK@[150, 1]:22",14,0
305,6000080,UR055,21,False,True,6003549,137,1,"LK@[138, 1]:21",6003573,161,1,"LK@[162, 1]:21",24,0
306,6000080,UR055,32,False,True,6003550,138,1,"LK@[139, 1]:32",6003554,142,1,"LK@[143, 1]:32",4,0
307,6000080,UR055,24,False,True,6003551,139,1,"LK@[140, 1]:24",6003563,151,1,"LK@[152, 1]:24",12,0
308,6000080,UR055,23,False,True,6003559,147,1,"LK@[148, 1]:23",6003568,156,1,"LK@[157, 1]:23",9,0
309,6000080,UR055,35,False,False,6003560,148,1,"PK@[149, 1]:35",6003585,173,1,"LK@[174, 1]:35",25,0
310,6000080,UR055,34,False,True,6003562,150,1,"LK@[151, 1]:34",6003582,170,1,"LK@[171, 1]:34",20,0
311,6000080,UR055,31,False,True,6003565,153,1,"LK@[154, 1]:31",6003566,154,1,"LK@[155, 1]:31",1,0
312,6000080,UR055,24,False,True,6003567,155,1,"LK@[156, 1]:24",6003575,163,1,"LK@[164, 1]:24",8,0
313,6000080,UR055,26,False,True,6003571,159,1,"LK@[160, 1]:26",6003574,162,1,"LK@[163, 1]:26",3,0
314,6000080,UR055,28,False,True,6003572,160,1,"LK@[161, 1]:28",6003590,178,1,"LK@[179, 1]:28",18,0
