,khipu_id,name,num_sum_cords,num_left_sums,num_right_sums,min_sum,max_sum,mean_sum,handedness
0,1000166,AS010,5,2,3,12,38,22,-0.4
1,1000167,AS011,0,0,0,0,0,0,0
2,1000180,AS012,7,4,3,11,30,18,-1.1428571428571428
3,1000184,AS013,5,5,0,13,120,48,-19
4,1000185,AS014,3,2,1,92,106,99,-4.666666666666667
5,1000186,AS015,0,0,0,0,0,0,0
6,1000187,AS016,1,0,1,12,12,12,4
7,1000188,AS017,0,0,0,0,0,0,0
8,1000189,AS018,0,0,0,0,0,0,0
9,1000190,AS019,1,1,0,820,820,820,-2
10,1000191,AS020,1,0,1,37,37,37,7
11,1000192,AS021,19,11,8,11,32,19,-0.15789473684210525
12,1000194,AS023,0,0,0,0,0,0,0
13,1000195,AS024,0,0,0,0,0,0,0
14,1000196,AS025,0,0,0,0,0,0,0
15,1000197,AS026A,5,2,3,12,42,21,-0.8
16,1000198,AS026B,9,3,6,12,112,79,7
17,1000199,AS027,0,0,0,0,0,0,0
18,1000200,AS028,9,6,3,30,200,66,-2.3333333333333335
19,1000201,AS029,18,8,10,16,1739,212,2.0555555555555554
20,1000206,AS035C,0,0,0,0,0,0,0
21,1000207,AS035D,7,1,6,11,34,18,9
22,1000235,AS036,25,10,15,12,150,41,3.88
23,1000236,AS037,17,5,12,17,336,73,10.117647058823529
24,1000213,AS039,2,1,1,11,28,19,-1
25,1000209,AS041,3,2,1,80,300,170,-2
26,1000210,AS042,0,0,0,0,0,0,0
27,1000211,AS043,0,0,0,0,0,0,0
28,1000345,AS044,48,23,25,11,160,37,1.375
29,1000212,AS045,16,10,6,13,110,33,-4.25
30,1000229,AS048,11,5,6,11,17,14,0.2727272727272727
31,1000361,AS050,63,25,38,11,3654,367,40.888888888888886
32,1000179,AS054,4,1,3,40,451,150,3.25
33,1000182,AS055,0,0,0,0,0,0,0
34,1000173,AS059,0,0,0,0,0,0,0
35,1000171,AS060,0,0,0,0,0,0,0
36,1000177,AS061/MA036,0,0,0,0,0,0,0
37,1000178,AS062,0,0,0,0,0,0,0
38,1000216,AS063,0,0,0,0,0,0,0
39,1000223,AS063B,5,3,2,15,72,56,-1.4
40,1000217,AS064,0,0,0,0,0,0,0
41,1000218,AS065,0,0,0,0,0,0,0
42,1000224,AS065B,0,0,0,0,0,0,0
43,1000369,AS066,59,24,35,12,300,60,7.016949152542373
44,1000096,AS069,200,93,107,11,585,80,47.745
45,1000368,AS071,1,0,1,11,11,11,17
46,1000174,AS073,0,0,0,0,0,0,0
47,1000366,AS074,1,0,1,52,52,52,67
48,1000342,AS075,8,3,5,12,111,38,6.875
49,1000220,AS076,0,0,0,0,0,0,0
50,1000221,AS077,2,1,1,13,13,13,0
51,1000172,AS078,0,0,0,0,0,0,0
52,1000346,AS079,0,0,0,0,0,0,0
53,1000222,AS080,3,1,2,16,51,36,0.3333333333333333
54,1000225,AS081,0,0,0,0,0,0,0
55,1000226,AS082,0,0,0,0,0,0,0
56,1000168,AS083,0,0,0,0,0,0,0
57,1000231,AS085,0,0,0,0,0,0,0
58,1000232,AS089,0,0,0,0,0,0,0
59,1000233,AS090/N2,3,0,3,50,230,130,24.333333333333332
60,1000234,AS092,20,9,11,12,189,34,2
61,1000365,AS093,6,3,3,11,15,12,0.5
62,1000227,AS094,0,0,0,0,0,0,0
63,1000043,AS101 - Part 1,0,0,0,0,0,0,0
64,1000044,AS101 - Part 2,3,2,1,60,120,90,0
65,1000054,AS110,6,1,5,13,25,17,3.1666666666666665
66,1000055,AS111,0,0,0,0,0,0,0
67,1000056,AS112,0,0,0,0,0,0,0
68,1000071,AS115,0,0,0,0,0,0,0
69,1000078,AS122,0,0,0,0,0,0,0
70,1000082,AS125,0,0,0,0,0,0,0
71,1000085,AS128,45,24,21,11,743,120,-22.244444444444444
72,1000086,AS129,0,0,0,0,0,0,0
73,1000090,AS132,1,0,1,25,25,25,3
74,1000091,AS133,13,3,10,11,305,123,7.615384615384615
75,1000092,AS134,0,0,0,0,0,0,0
76,1000112,AS137,0,0,0,0,0,0,0
77,1000114,AS139,0,0,0,0,0,0,0
78,1000117,AS142,0,0,0,0,0,0,0
79,1000128,AS153,3,2,1,13,46,27,-2.6666666666666665
80,1000130,AS155,0,0,0,0,0,0,0
81,1000131,AS156,10,2,8,40,360,158,6.1
82,1000132,AS157,0,0,0,0,0,0,0
83,1000133,AS158,0,0,0,0,0,0,0
84,1000058,AS159,21,9,12,12,79,26,2.8095238095238093
85,1000064,AS160,4,2,2,20,30,25,-1.75
86,1000138,AS164,8,3,5,11,55,26,2.25
87,1000142,AS168,2,0,2,60,70,65,8.5
88,1000143,AS169,0,0,0,0,0,0,0
89,1000144,AS170,6,3,3,22,340,212,-13.833333333333334
90,1000145,AS171,4,0,4,13,30,23,6.75
91,1000146,AS172,8,3,5,20,1200,573,1
92,1000059,AS173,2,1,1,18,66,42,0
93,1000060,AS174,2,0,2,14,16,15,2
94,1000149,AS177,0,0,0,0,0,0,0
95,1000150,AS178,5,1,4,20,335,93,3.4
96,1000154,AS182,0,0,0,0,0,0,0
97,1000155,AS182B,0,0,0,0,0,0,0
98,1000156,AS183,1,1,0,55,55,55,-1
99,1000157,AS184,0,0,0,0,0,0,0
100,1000158,AS185,8,2,6,15,170,44,3.375
101,1000159,AS186,2,1,1,11,20,15,6
102,1000160,AS187,0,0,0,0,0,0,0
103,1000161,AS188,0,0,0,0,0,0,0
104,1000162,AS189,5,0,5,13,40,27,8.8
105,1000066,AS191,0,0,0,0,0,0,0
106,1000067,AS192,2,0,2,35,110,72,5.5
107,1000068,AS193,0,0,0,0,0,0,0
108,1000061,AS194,0,0,0,0,0,0,0
109,1000062,AS195,0,0,0,0,0,0,0
110,1000069,AS196,0,0,0,0,0,0,0
111,1000070,AS197,0,0,0,0,0,0,0
112,1000163,AS198,0,0,0,0,0,0,0
113,1000164,AS199,30,21,9,15,922,170,-7.5
114,1000165,AS200,1,1,0,600,600,600,-7
115,1000026,AS201,2,1,1,14,14,14,1
116,1000013,AS202,0,0,0,0,0,0,0
117,1000014,AS203,0,0,0,0,0,0,0
118,1000027,AS204,0,0,0,0,0,0,0
119,1000028,AS205,0,0,0,0,0,0,0
120,1000015,AS206,9,6,3,30,142,78,-6.777777777777778
121,1000029,AS207A,24,8,16,11,112,38,6.166666666666667
122,1000030,AS207B,1,1,0,19,19,19,-1
123,1000031,AS207C,0,0,0,0,0,0,0
124,1000032,AS209,3,2,1,215,6569,3125,-3.3333333333333335
125,1000017,AS210,10,5,5,11,50,32,-1
126,1000033,AS211,8,4,4,13,37,26,2.125
127,1000034,AS212,31,13,18,11,70,27,2.6129032258064515
128,1000035,AS213,1,0,1,16,16,16,4
129,1000036,AS214,4,1,3,13,30,18,3.75
130,1000037,AS215,7,3,4,11,76,25,1.2857142857142858
131,1000038,AS215F,0,0,0,0,0,0,0
132,1000204,AS35A,0,0,0,0,0,0,0
133,1000205,AS35B,0,0,0,0,0,0,0
134,1000420,HP001,0,0,0,0,0,0,0
135,1000421,HP002,0,0,0,0,0,0,0
136,1000422,HP003,17,12,5,52,355,143,-11
137,1000423,HP004,1,0,1,45,45,45,6
138,1000424,HP005,3,2,1,12,32,18,-3
139,1000425,HP006,0,0,0,0,0,0,0
140,1000426,HP007,0,0,0,0,0,0,0
141,1000427,HP008,0,0,0,0,0,0,0
142,1000428,HP009,0,0,0,0,0,0,0
143,1000429,HP010,0,0,0,0,0,0,0
144,1000430,HP011,1,0,1,150,150,150,8
145,1000431,HP012,0,0,0,0,0,0,0
146,1000432,HP013,0,0,0,0,0,0,0
147,1000433,HP014,10,8,2,14,272,62,-11.1
148,1000434,HP015,0,0,0,0,0,0,0
149,1000435,HP016,0,0,0,0,0,0,0
150,1000436,HP017,16,7,9,70,155,95,-6.0625
151,1000437,HP018,7,4,3,11,88,38,-0.42857142857142855
152,1000438,HP019,0,0,0,0,0,0,0
153,1000439,HP020,2,1,1,12,12,12,0.5
154,1000440,HP021,0,0,0,0,0,0,0
155,1000441,HP022,3,0,3,16,29,23,4.333333333333333
156,1000442,HP023,0,0,0,0,0,0,0
157,1000443,HP024,0,0,0,0,0,0,0
158,1000444,HP025,0,0,0,0,0,0,0
159,1000445,HP026,0,0,0,0,0,0,0
160,1000446,HP027,1,0,1,762,762,762,44
161,1000447,HP028,0,0,0,0,0,0,0
162,1000448,HP029,3,1,2,53,1732,753,8.333333333333334
163,1000449,HP030,10,7,3,200,2783,811,-11.9
164,1000450,HP031,0,0,0,0,0,0,0
165,1000451,HP032,1,0,1,18,18,18,6
166,1000562,HP033,5,2,3,13,16,14,2.2
167,1000563,HP034,12,4,8,32,1165,449,24.333333333333332
168,1000566,HP037,4,2,2,267,1334,633,1.5
169,1000567,HP038,0,0,0,0,0,0,0
170,1000593,HP039,22,3,19,49,1215,283,27.454545454545453
171,1000569,HP040,1,1,0,12,12,12,-3
172,1000571,HP042,0,0,0,0,0,0,0
173,1000572,HP043,1,1,0,19,19,19,-9
174,1000573,HP044,1,0,1,15,15,15,10
175,1000575,HP046 A,4,2,2,14,20,17,4
176,1000576,HP046 B,8,4,4,14,29,23,1.5
177,1000579,HP049,0,0,0,0,0,0,0
178,1000580,HP050,1,1,0,22,22,22,-8
179,1000581,HP051 A,7,2,5,12,80,31,4.428571428571429
180,1000582,HP051 B,3,1,2,20,70,36,3.6666666666666665
181,1000583,HP052,17,10,7,30,70,53,-0.9411764705882353
182,1000584,HP053,8,4,4,30,140,80,2.25
183,1000585,HP054,3,2,1,13,63,30,-0.3333333333333333
184,1000586,HP056,74,38,36,11,231,39,1.2837837837837838
185,1000587,HP057,2,0,2,11,14,12,7.5
186,1000625,JC001,9,2,7,12,80,52,0.7777777777777778
187,1000626,JC002,0,0,0,0,0,0,0
188,1000627,JC003,0,0,0,0,0,0,0
189,1000628,JC004,0,0,0,0,0,0,0
190,1000629,JC005,54,22,32,12,913,67,15.092592592592593
191,1000630,JC006,0,0,0,0,0,0,0
192,1000631,JC007,0,0,0,0,0,0,0
193,1000632,JC008,0,0,0,0,0,0,0
194,1000633,JC009,29,11,18,11,62,28,3.6551724137931036
195,1000634,JC010,33,15,18,11,50,23,1.7575757575757576
196,1000635,JC011,11,5,6,13,23,17,0.18181818181818182
197,1000636,JC012,0,0,0,0,0,0,0
198,1000637,JC013,16,5,11,13,76,36,6.625
199,1000638,JC014,0,0,0,0,0,0,0
200,1000639,JC015,0,0,0,0,0,0,0
201,1000640,JC016,0,0,0,0,0,0,0
202,1000641,JC017,0,0,0,0,0,0,0
203,1000642,JC018,0,0,0,0,0,0,0
204,1000643,JC019,0,0,0,0,0,0,0
205,1000644,JC020,0,0,0,0,0,0,0
206,1000645,JC021,0,0,0,0,0,0,0
207,1000646,JC022,0,0,0,0,0,0,0
208,1000647,JC023,0,0,0,0,0,0,0
209,1000012,UR002,16,0,16,22,1054,248,21.125
210,1000020,UR003,1,1,0,11,11,11,-8
211,1000005,UR005,18,14,4,18,135,69,-14.222222222222221
212,1000025,UR006,24,13,11,11,21,14,1.125
213,1000006,UR007,0,0,0,0,0,0,0
214,1000001,UR008,0,0,0,0,0,0,0
215,1000019,UR009,12,6,6,11,61,22,-1.25
216,1000004,UR010,103,54,49,11,153,36,1.4271844660194175
217,1000007,UR011,33,12,21,21,951,132,20.666666666666668
218,1000009,UR012,19,4,15,13,159,35,8.157894736842104
219,1000008,UR013,4,4,0,15,66,46,-5.75
220,1000011,UR014,2,1,1,14,19,16,-2
221,1000010,UR015,7,4,3,60,2018,582,-0.14285714285714285
222,1000018,UR016,86,40,46,11,99,34,0.5930232558139535
223,1000003,UR018,1,1,0,95,95,95,-9
224,1000000,UR019,0,0,0,0,0,0,0
225,1000002,UR020,1,0,1,404,404,404,10
226,1000022,UR021,11,7,4,11,61,25,0.7272727272727273
227,1000045,UR022,130,49,81,12,572,58,26.06153846153846
228,1000307,UR023,0,0,0,0,0,0,0
229,1000306,UR024,0,0,0,0,0,0,0
230,1000335,UR026,5,3,2,34,830,417,-8.4
231,1000303,UR027,0,0,0,0,0,0,0
232,1000304,UR028,3,0,3,12,29,18,5
233,1000305,UR029,0,0,0,0,0,0,0
234,1000330,UR032,2,0,2,107,204,155,14
235,1000276,UR033,0,0,0,0,0,0,0
236,1000380,UR034,36,17,19,11,766,73,1.3611111111111112
237,1000331,UR037,17,6,11,14,42,23,4.352941176470588
238,1000277,UR038,3,2,1,30,297,170,0.6666666666666666
239,1000098,UR040,0,0,0,0,0,0,0
240,1000099,UR041,10,5,5,12,32,22,0.9
241,1000100,UR042,2,0,2,14,25,19,3.5
242,1000332,UR045,14,8,6,11,21,14,0.42857142857142855
243,1000241,UR046,0,0,0,0,0,0,0
244,1000240,UR047,5,3,2,60,120,88,-2
245,1000239,UR048,6,2,4,12,25,16,5.5
246,1000238,UR049,55,33,22,15,610,200,-22.87272727272727
247,1000375,UR051,15,7,8,11,28,15,1.4666666666666666
248,1000265,UR053A,1,0,1,372,372,372,22
249,1000266,UR053B,6,0,6,27,74,51,7.5
250,1000267,UR053C,17,8,9,16,74,44,1
251,1000268,UR053D,23,11,12,24,311,115,9.130434782608695
252,1000269,UR053E,35,16,19,11,81,26,1.7428571428571429
253,1000295,UR056A,6,4,2,11,54,22,-3.6666666666666665
254,1000296,UR056B,12,6,6,15,45,26,0
255,1000297,UR056C,5,2,3,11,51,24,3.4
256,1000309,UR057,2,0,2,16,20,18,8
257,1000298,UR058A,0,0,0,0,0,0,0
258,1000299,UR058B,0,0,0,0,0,0,0
259,1000390,UR059,28,17,11,12,236,46,0.14285714285714285
260,1000264,UR060,2,1,1,16,16,16,1.5
261,1000246,UR061,5,1,4,38,148,85,10.4
262,1000243,UR062,3,1,2,43,203,122,4.333333333333333
263,1000259,UR063,9,6,3,12,157,43,-8.11111111111111
264,1000263,UR064,10,4,6,12,64,42,4.6
265,1000242,UR065,0,0,0,0,0,0,0
266,1000261,UR066,1,1,0,12,12,12,-4
267,1000260,UR067,2,2,0,12,22,17,-7
268,1000262,UR068,10,4,6,13,64,47,1.9
269,1000245,UR069,8,4,4,14,140,52,-3.625
270,1000247,UR070,0,0,0,0,0,0,0
271,1000248,UR071,0,0,0,0,0,0,0
272,1000249,UR072,14,4,10,12,100,28,6.071428571428571
273,1000250,UR073,7,4,3,11,148,69,-8.714285714285714
274,1000251,UR074,5,2,3,22,34,30,2.4
275,1000252,UR075,0,0,0,0,0,0,0
276,1000253,UR076,0,0,0,0,0,0,0
277,1000244,UR077,0,0,0,0,0,0,0
278,1000254,UR078,0,0,0,0,0,0,0
279,1000255,UR079,5,3,2,20,50,32,-2.2
280,1000256,UR080,1,0,1,23,23,23,7
281,1000257,UR081,0,0,0,0,0,0,0
282,1000258,UR082,0,0,0,0,0,0,0
283,1000319,UR084,0,0,0,0,0,0,0
284,1000280,UR085,35,14,21,63,5161,535,23.37142857142857
285,1000336,UR086,46,18,28,12,897,67,6.456521739130435
286,1000273,UR087,65,33,32,11,26,15,-0.015384615384615385
287,1000270,UR088,6,4,2,19,184,84,-5.5
288,1000275,UR089,60,31,29,11,71,36,0.21666666666666667
289,1000274,UR090,50,28,22,11,172,49,4.1
290,1000271,UR091,13,10,3,12,73,47,-10.076923076923077
291,1000272,UR092,0,0,0,0,0,0,0
292,1000321,UR093,16,8,8,11,73,28,2.75
293,1000337,UR094,1,0,1,40,40,40,17
294,1000338,UR095,6,2,4,13,33,21,5.5
295,1000339,UR096,0,0,0,0,0,0,0
296,1000340,UR097,9,6,3,11,77,25,-3
297,1000347,UR098,0,0,0,0,0,0,0
298,1000348,UR099,0,0,0,0,0,0,0
299,1000349,UR100,0,0,0,0,0,0,0
300,1000350,UR101,0,0,0,0,0,0,0
301,1000351,UR102,9,7,2,20,41,28,-10.555555555555555
302,1000352,UR103,0,0,0,0,0,0,0
303,1000103,UR1032,1,0,1,11,11,11,11
304,1000105,UR1033A,1,0,1,20,20,20,4
305,1000106,UR1033B,0,0,0,0,0,0,0
306,1000107,UR1033C,0,0,0,0,0,0,0
307,1000108,UR1033D,5,1,4,16,60,33,6.4
308,1000109,UR1033E,0,0,0,0,0,0,0
309,1000110,UR1033F,3,1,2,12,47,24,5.333333333333333
310,1000111,UR1033G,0,0,0,0,0,0,0
311,1000333,UR1034,31,22,9,11,248,58,-9.32258064516129
312,1000353,UR104,3,1,2,13,23,19,2.3333333333333335
313,1000208,UR1040,1,1,0,66,66,66,-4
314,1000230,UR1049,0,0,0,0,0,0,0
315,1000354,UR105,0,0,0,0,0,0,0
316,1000214,UR1051,2,2,0,11,42,26,-10.5
317,1000170,UR1052,0,0,0,0,0,0,0
318,1000169,UR1053,0,0,0,0,0,0,0
319,1000183,UR1057,21,14,7,11,104,31,1.8095238095238095
320,1000176,UR1058,0,0,0,0,0,0,0
321,1000355,UR106,0,0,0,0,0,0,0
322,1000356,UR107,2,2,0,20,21,20,-6
323,1000357,UR108,0,0,0,0,0,0,0
324,1000344,UR1084,56,27,29,22,1575,359,-0.8392857142857143
325,1000310,UR1087,22,9,13,14,1620,172,4.7272727272727275
326,1000313,UR1088,9,2,7,12,110,29,9.777777777777779
327,1000358,UR109,0,0,0,0,0,0,0
328,1000312,UR1091,19,8,11,11,116,34,2.8421052631578947
329,1000314,UR1095,81,46,35,11,2113,74,-2.5555555555555554
330,1000315,UR1096,20,10,10,12,60,25,1.15
331,1000039,UR1097,0,0,0,0,0,0,0
332,1000040,UR1098,7,2,5,11,118,44,13.428571428571429
333,1000041,UR1099,3,0,3,212,222,216,26.666666666666668
334,1000042,UR1100,10,0,10,11,259,53,9.9
335,1000046,UR1102,5,4,1,30,60,44,-6.8
336,1000047,UR1103,5,3,2,73,394,208,-6.4
337,1000048,UR1104,0,0,0,0,0,0,0
338,1000049,UR1105,1,0,1,28,28,28,3
339,1000050,UR1106,5,1,4,23,600,299,3.6
340,1000051,UR1107,6,2,4,28,215,75,5
341,1000052,UR1108,2,1,1,17,17,17,0
342,1000053,UR1109,41,19,22,110,400,206,9.707317073170731
343,1000359,UR111,20,8,12,17,300,57,4.4
344,1000057,UR1113,60,27,33,29,256,82,2.6666666666666665
345,1000063,UR1114,126,63,63,11,703,83,8.619047619047619
346,1000072,UR1116,1,0,1,170,170,170,6
347,1000073,UR1117,0,0,0,0,0,0,0
348,1000074,UR1118,0,0,0,0,0,0,0
349,1000075,UR1119,0,0,0,0,0,0,0
350,1000076,UR1120,0,0,0,0,0,0,0
351,1000077,UR1121,3,3,0,14,17,15,-50.666666666666664
352,1000079,UR1123,19,6,13,20,1320,261,13.105263157894736
353,1000080,UR1124,8,5,3,18,154,65,-3.5
354,1000081,UR1124 Detail 1,0,0,0,0,0,0,0
355,1000083,UR1126,16,12,4,22,214,72,-15.125
356,1000084,UR1127,2,1,1,45,175,110,0.5
357,1000292,UR113,135,62,73,11,620,68,2.4814814814814814
358,1000087,UR1130,0,0,0,0,0,0,0
359,1000089,UR1131,55,28,27,11,343,89,-7.963636363636364
360,1000093,UR1135,2,0,2,13,14,13,6
361,1000094,UR1136,96,47,49,14,180,52,3.5416666666666665
362,1000113,UR1138,6,4,2,110,220,165,-3.8333333333333335
363,1000287,UR114,8,5,3,11,20,13,-8.5
364,1000115,UR1140,125,51,74,11,114,38,9.528
365,1000116,UR1141,0,0,0,0,0,0,0
366,1000118,UR1143,0,0,0,0,0,0,0
367,1000119,UR1144,7,4,3,56,243,112,-7.857142857142857
368,1000120,UR1145,20,12,8,12,1497,343,-10.55
369,1000121,UR1146,22,10,12,11,64,15,-0.22727272727272727
370,1000122,UR1147,2,0,2,272,385,328,7
371,1000123,UR1148,0,0,0,0,0,0,0
372,1000124,UR1149,11,2,9,85,3440,1040,32.90909090909091
373,1000125,UR1150,5,2,3,30,117,71,3.2
374,1000126,UR1151,2,1,1,13,26,19,-0.5
375,1000127,UR1152,14,8,6,28,822,294,-0.6428571428571429
376,1000129,UR1154,0,0,0,0,0,0,0
377,1000134,UR1161,1,1,0,50,50,50,-4
378,1000135,UR1162A,0,0,0,0,0,0,0
379,1000136,UR1162B,0,0,0,0,0,0,0
380,1000137,UR1163,7,2,5,12,105,28,2.4285714285714284
381,1000139,UR1165,1,0,1,91,91,91,5
382,1000140,UR1166,35,17,18,11,65,26,-1.6285714285714286
383,1000141,UR1167,0,0,0,0,0,0,0
384,1000285,UR116A,14,7,7,12,37,24,-0.42857142857142855
385,1000283,UR116B,2,1,1,22,24,23,-2
386,1000147,UR1175,104,46,58,11,445,86,9.740384615384615
387,1000148,UR1176,56,14,42,11,554,87,28.464285714285715
388,1000151,UR1179,1,1,0,50,50,50,-9
389,1000288,UR117A,0,0,0,0,0,0,0
390,1000289,UR117B,0,0,0,0,0,0,0
391,1000290,UR117C,1,0,1,11,11,11,5
392,1000291,UR117D,2,2,0,30,33,31,-4
393,1000293,UR118,71,39,32,12,1957,228,-16.985915492957748
394,1000152,UR1180,0,0,0,0,0,0,0
395,1000329,UR119,56,23,33,36,522,197,9.642857142857142
396,1000320,UR120,20,6,14,12,310,52,4.85
397,1000322,UR121,3,1,2,11,14,12,0.6666666666666666
398,1000323,UR122,1,0,1,2667,2667,2667,41
399,1000324,UR123,10,6,4,13,221,52,0.6
400,1000325,UR124,0,0,0,0,0,0,0
401,1000326,UR125,0,0,0,0,0,0,0
402,1000328,UR127,1,1,0,14,14,14,-13
403,1000377,UR128,3,1,2,23,36,27,0.3333333333333333
404,1000378,UR129,0,0,0,0,0,0,0
405,1000316,UR130,12,8,4,20,85,45,-4.666666666666667
406,1000300,UR131A,5,1,4,21,609,262,8.2
407,1000301,UR131B,7,3,4,11,560,138,7.571428571428571
408,1000302,UR131C,14,5,9,11,690,126,6.357142857142857
409,1000317,UR132,2,1,1,14,20,17,0
410,1000452,UR134,0,0,0,0,0,0,0
411,1000389,UR135,0,0,0,0,0,0,0
412,1000388,UR136,0,0,0,0,0,0,0
413,1000387,UR137,8,2,6,11,83,28,3.125
414,1000386,UR138,0,0,0,0,0,0,0
415,1000407,UR139,2,0,2,16,53,34,10.5
416,1000408,UR140,0,0,0,0,0,0,0
417,1000409,UR141,4,1,3,20,650,227,1.5
418,1000406,UR142,0,0,0,0,0,0,0
419,1000401,UR143,2,1,1,69,220,144,6
420,1000415,UR145,6,3,3,32,515,239,2.8333333333333335
421,1000418,UR146,7,4,3,20,180,95,-2.142857142857143
422,1000400,UR147,2,1,1,300,1000,650,-12.5
423,1000414,UR148,0,0,0,0,0,0,0
424,1000413,UR149,53,26,27,11,601,110,-5.754716981132075
425,1000405,UR150,3,1,2,15,25,18,1
426,1000404,UR151,4,4,0,50,120,85,-4.5
427,1000402,UR152,2,1,1,20,110,65,-1
428,1000403,UR153,8,6,2,90,740,467,-11.375
429,1000399,UR154,1,0,1,311,311,311,7
430,1000410,UR156,0,0,0,0,0,0,0
431,1000416,UR157,1,1,0,12,12,12,-6
432,1000417,UR158,0,0,0,0,0,0,0
433,1000411,UR159,0,0,0,0,0,0,0
434,1000397,UR160,6,3,3,14,44,30,1
435,1000395,UR161,0,0,0,0,0,0,0
436,1000393,UR162,0,0,0,0,0,0,0
437,1000412,UR164,0,0,0,0,0,0,0
438,1000496,UR166,6,3,3,16,1417,587,2.1666666666666665
439,1000475,UR168,1,0,1,34,34,34,3
440,1000477,UR169,8,0,8,13,75,42,7.75
441,1000492,UR170,0,0,0,0,0,0,0
442,1000478,UR171,0,0,0,0,0,0,0
443,1000479,UR172,2,0,2,40,90,65,11
444,1000481,UR173,1,0,1,26,26,26,2
445,1000480,UR174,2,2,0,15,66,40,-4.5
446,1000483,UR175,0,0,0,0,0,0,0
447,1000494,UR177,11,3,8,12,39,21,5.545454545454546
448,1000485,UR178,0,0,0,0,0,0,0
449,1000489,UR179,0,0,0,0,0,0,0
450,1000486,UR180,0,0,0,0,0,0,0
451,1000482,UR182,3,2,1,13,118,79,0.3333333333333333
452,1000487,UR183,0,0,0,0,0,0,0
453,1000488,UR184,5,4,1,11,79,39,-4.6
454,1000490,UR185,0,0,0,0,0,0,0
455,1000497,UR186,20,11,9,13,596,89,-1.1
456,1000495,UR187,1,0,1,154,154,154,23
457,1000499,UR188,1,0,1,24072,24072,24072,1
458,1000500,UR189,21,10,11,11,226,40,-0.23809523809523808
459,1000502,UR191,0,0,0,0,0,0,0
460,1000503,UR192,13,5,8,11,70,33,7.230769230769231
461,1000505,UR194,11,7,4,19,53,33,-4.181818181818182
462,1000506,UR195,21,9,12,12,110,27,-0.9047619047619048
463,1000507,UR196,10,4,6,11,61,21,1.5
464,1000508,UR197,76,29,47,11,4657,294,17.486842105263158
465,1000509,UR198,55,28,27,11,38,16,-0.09090909090909091
466,1000510,UR199,27,17,10,11,78,42,-5.444444444444445
467,1000511,UR200,1,0,1,523,523,523,24
468,1000512,UR201,2,0,2,537,1335,936,62.5
469,1000513,UR202,37,14,23,20,700,93,4.864864864864865
470,1000514,UR203,59,25,34,11,55,26,3.8983050847457625
471,1000515,UR204,10,4,6,12,50,34,2.6
472,1000516,UR205,3,3,0,11,21,15,-8
473,1000517,UR206,0,0,0,0,0,0,0
474,1000518,UR207,39,18,21,12,458,80,1.4615384615384615
475,1000519,UR208,49,21,28,13,600,117,6.428571428571429
476,1000520,UR209,11,6,5,16,200,48,-1.1818181818181819
477,1000521,UR210,2,0,2,218,311,264,32.5
478,1000522,UR211,14,7,7,20,1120,188,1
479,1000523,UR212,102,46,56,11,479,66,4.519607843137255
480,1000524,UR213,48,21,27,11,385,83,5.541666666666667
481,1000525,UR214,2,1,1,15,15,15,-4
482,1000526,UR215,32,16,16,11,40,22,0.28125
483,1000527,UR216,0,0,0,0,0,0,0
484,1000528,UR217,18,10,8,11,2000,221,-2.888888888888889
485,1000529,UR218,21,4,17,26,620,195,17.047619047619047
486,1000530,UR219,4,0,4,60,650,272,20.75
487,1000531,UR220,1,1,0,37,37,37,-7
488,1000533,UR222,11,8,3,12,110,43,-6.818181818181818
489,1000534,UR223,20,7,13,16,115,40,4.2
490,1000535,UR225,6,2,4,15,40,28,4.833333333333333
491,1000536,UR226,5,2,3,216,786,453,4.2
492,1000537,UR227,7,3,4,40,90,57,1.4285714285714286
493,1000538,UR228,19,8,11,20,90,53,-0.15789473684210525
494,1000539,UR229,68,27,41,13,153,44,9.088235294117647
495,1000540,UR230,16,7,9,11,143,32,-2.1875
496,1000541,UR231,186,89,97,11,789,169,19.172043010752688
497,1000542,UR232,38,25,13,12,156,51,-8.289473684210526
498,1000543,UR233,36,14,22,11,290,76,8.25
499,1000544,UR234,3,3,0,989,2500,1532,-42.666666666666664
500,1000545,UR235,39,13,26,12,712,56,6.564102564102564
501,1000551,UR237,5,4,1,28,105,56,-3
502,1000552,UR238,7,2,5,11,105,29,2.4285714285714284
503,1000553,UR239,1,1,0,15,15,15,-3
504,1000554,UR240,23,5,18,17,1677,178,13.826086956521738
505,1000549,UR241,8,5,3,12,61,30,-2.75
506,1000547,UR242,74,35,39,11,170,41,2.8783783783783785
507,1000548,UR243,4,3,1,15,48,27,-5
508,1000555,UR244,10,3,7,13,48,24,2.3
509,1000550,UR245,1,0,1,11,11,11,4
510,1000556,UR246,6,3,3,18,316,203,1.5
511,1000558,UR247,0,0,0,0,0,0,0
512,1000559,UR248,0,0,0,0,0,0,0
513,1000560,UR249,0,0,0,0,0,0,0
514,1000561,UR250,0,0,0,0,0,0,0
515,1000589,UR251,1,1,0,14,14,14,-21
516,1000590,UR252,6,3,3,12,102,29,0.8333333333333334
517,1000592,UR254,1,1,0,30,30,30,-2
518,1000597,UR255,20,3,17,34,238,135,8.6
519,1000598,UR256,22,9,13,50,2002,539,0.36363636363636365
520,1000595,UR257,0,0,0,0,0,0,0
521,1000599,UR258,12,2,10,28,347,66,12.083333333333334
522,1000600,UR259,0,0,0,0,0,0,0
523,1000601,UR260,4,4,0,19,111,54,-9
524,1000602,UR261,0,0,0,0,0,0,0
525,1000603,UR262,32,6,26,20,1180,266,37.5625
526,1000604,UR263,16,7,9,11,14,12,-0.625
527,1000605,UR264,96,37,59,11,180,55,9
528,1000606,UR265,0,0,0,0,0,0,0
529,1000607,UR266,6,1,5,370,4273,2002,6.833333333333333
530,1000608,UR267A,28,6,22,34,238,133,4.071428571428571
531,1000609,UR267B,24,6,18,121,660,435,-3.875
532,1000610,UR268,1,0,1,9793,9793,9793,2
533,1000611,UR269,38,14,24,40,2797,1622,-18.57894736842105
534,1000612,UR270,36,18,18,104,1296,246,9.805555555555555
535,1000613,UR271,0,0,0,0,0,0,0
536,1000614,UR272,26,12,14,11,54,24,1.2692307692307692
537,1000615,UR273A,1,0,1,672,672,672,23
538,1000616,UR273B,1,1,0,40,40,40,-2
539,1000617,UR274A,2,0,2,113,143,128,3.5
540,1000618,UR274B,7,4,3,320,2300,1351,-1.2857142857142858
541,1000619,UR275,15,4,11,250,4273,1815,-5.066666666666666
542,1000620,UR276,0,0,0,0,0,0,0
543,1000622,UR277,59,25,34,11,1167,111,5.52542372881356
544,1000623,UR278,70,17,53,109,1918,348,46.42857142857143
545,1000621,UR279,0,0,0,0,0,0,0
546,1000649,UR282,2,1,1,20,20,20,-1.5
547,1000650,UR283,37,21,16,11,440,70,-3.918918918918919
548,1000651,UR284,3,1,2,16,96,54,3
549,1000652,UR285,0,0,0,0,0,0,0
550,1000653,UR286,1,0,1,34,34,34,3
551,1000654,UR287,3,2,1,30,100,53,-4.666666666666667
552,1000655,UR288,1,0,1,13,13,13,6
553,1000656,UR289,1,1,0,20,20,20,-7
554,1000657,UR290,0,0,0,0,0,0,0
555,1000658,UR291A,31,14,17,11,400,68,2.064516129032258
556,1000660,UR293,0,0,0,0,0,0,0
557,1000661,UR294,0,0,0,0,0,0,0
558,6000000,AS001,1,1,0,101,101,101,-4
559,6000001,AS002,1,1,0,117,117,117,-4
560,6000002,AS003,2,2,0,14,76,45,-4
561,6000003,AS004,2,1,1,312,601,456,0.5
562,6000004,AS005,5,3,2,11,12,11,0.2
563,6000005,AS006,16,11,5,20,140,82,-3.4375
564,6000006,AS007,82,39,43,11,170,44,1.8780487804878048
565,6000007,AS008,86,56,30,16,5474,480,-29.08139534883721
566,6000008,AS009,0,0,0,0,0,0,0
567,6000009,AS072,9,4,5,40,520,156,-0.1111111111111111
568,6000010,HP045,5,2,3,11,54,29,10
569,6000011,HP047,1,0,1,328,328,328,3
570,6000012,HP048,0,0,0,0,0,0,0
571,6000013,HP055,20,7,13,33,1089,453,14.2
572,6000014,KH0001,29,17,12,39,223,89,-2.8275862068965516
573,6000015,KH0032,2,1,1,33,221,127,2
574,6000016,KH0033,2,1,1,28,158,93,-0.5
575,6000017,KH0049,5,3,2,1016,6485,3447,-6.2
576,6000018,KH0057,18,5,13,11,191,45,10.833333333333334
577,6000019,KH0058,46,19,27,17,115,46,8.5
578,6000020,KH0067,0,0,0,0,0,0,0
579,6000021,KH0080,16,13,3,13,244,62,-44.75
580,6000022,KH0081,154,55,99,11,5928,347,12.863636363636363
581,6000023,KH0083,3,2,1,17,748,265,-8
582,6000024,KH0197,11,1,10,14,564,187,10
583,6000025,KH0227,50,31,19,11,90,30,-7.88
584,6000026,KH0267,0,0,0,0,0,0,0
585,6000027,KH0350,3,2,1,11,12,11,-8.666666666666666
586,6000028,MM001,127,62,65,14,461,83,-0.9606299212598425
587,6000029,MM002,16,8,8,30,540,112,-0.3125
588,6000030,MM003,1,1,0,80,80,80,-3
589,6000031,MM004,11,5,6,20,80,38,5.7272727272727275
590,6000032,MM005,2,1,1,20,20,20,1.5
591,6000033,MM006/AN001,1,1,0,154,154,154,-4
592,6000034,MM007/AN002,11,6,5,11,21,14,-0.09090909090909091
593,6000035,MM008,5,2,3,29,103,59,0.6
594,6000036,MM009,0,0,0,0,0,0,0
595,6000037,MM010,0,0,0,0,0,0,0
596,6000038,MM011,0,0,0,0,0,0,0
597,6000039,MM012,0,0,0,0,0,0,0
598,6000040,MM013,0,0,0,0,0,0,0
599,6000041,MM014,0,0,0,0,0,0,0
600,6000042,MM015,5,3,2,25,53,36,-1.4
601,6000043,MM016,3,2,1,23,65,40,-4
602,6000044,MM017,0,0,0,0,0,0,0
603,6000045,MM018,0,0,0,0,0,0,0
604,6000046,MM019,26,10,16,11,201,36,11.76923076923077
605,6000047,MM020,18,9,9,16,330,73,-0.6111111111111112
606,6000048,MM021,27,15,12,11,100,23,-6.037037037037037
607,6000049,MM1086,4,4,0,11,340,161,-15.25
608,6000050,QU001,0,0,0,0,0,0,0
609,6000051,QU002,19,6,13,11,94,22,4.315789473684211
610,6000052,QU003,3,3,0,104,226,148,-20.333333333333332
611,6000053,QU004,2,1,1,31,31,31,3
612,6000054,QU005,5,4,1,115,341,185,-6.8
613,6000055,QU006,0,0,0,0,0,0,0
614,6000056,QU007,31,15,16,11,42,21,0.1935483870967742
615,6000057,QU008,3,2,1,34,40,37,0
616,6000058,QU009,49,22,27,11,239,37,3.061224489795918
617,6000059,QU010,5,1,4,24,1000,394,7.6
618,6000060,QU011,58,31,27,11,2388,214,-5.120689655172414
619,6000061,QU012,67,32,35,11,560,66,1.955223880597015
620,6000062,QU013,27,13,14,11,300,60,-10.11111111111111
621,6000063,QU014,66,31,35,13,935,139,11.803030303030303
622,6000064,QU015,45,15,30,11,2792,191,16.955555555555556
623,6000065,QU016,17,9,8,15,129,41,0.7058823529411765
624,6000066,QU017,2,1,1,21,34,27,14
625,6000067,QU018,6,3,3,12,204,51,-1.1666666666666667
626,6000068,QU019,96,41,55,11,601,65,9.208333333333334
627,6000069,QU020,3,1,2,12,14,13,3.3333333333333335
628,6000070,QU021,25,11,14,11,55,27,1.84
629,6000071,QU022,0,0,0,0,0,0,0
630,6000072,UR001,43,20,23,13,1208,272,-2.9767441860465116
631,6000073,UR004,198,93,105,11,2230,79,3.474747474747475
632,6000074,UR017,37,23,14,11,211,35,-4.72972972972973
633,6000075,UR039,57,35,22,11,224,34,-6.7368421052631575
634,6000077,UR050,2,1,1,21,21,21,-22
635,6000078,UR052,28,15,13,11,33,22,-1.3214285714285714
636,6000079,UR054,16,8,8,13,25,20,0.4375
637,6000080,UR055,30,13,17,21,46,37,12.133333333333333
638,6000081,UR110,11,5,6,11,25,15,2.090909090909091
639,6000082,UR112,11,5,6,11,21,14,-0.18181818181818182
640,6000083,UR144,19,9,10,11,114,34,-0.8947368421052632
641,6000084,UR155,10,5,5,12,120,35,0.9
642,6000085,UR165,0,0,0,0,0,0,0
643,6000086,UR167,2,0,2,20,35,27,10
644,6000087,UR190,131,67,64,11,47,26,-0.8854961832061069
645,6000088,UR193,45,18,27,20,120,55,7.555555555555555
646,6000089,UR221,0,0,0,0,0,0,0
647,6000090,UR253,26,14,12,11,106,32,1.3076923076923077
648,6000091,UR280,2,0,2,87,150,118,18
649,6000092,UR292A,1,0,1,20,20,20,5
